a_la_carte	table_d'hote
abducent	adducent
abience	adience
ability	inability
abnormality	normality
above	below
abruptness	gradualness
absence	presence
absolute	relative
absorbency	nonabsorbency
absorbent	nonabsorbent
abstract	concrete
abstractness	concreteness
abundance	scarcity
acatalectic	hypercatalectic	catalectic
acceleration	deceleration
acceptability	unacceptability
acceptance	rejection
accessibility	inaccessibility
accrual_basis	cash_basis
accuracy	inaccuracy
achiever	loser
achromatic_color	chromatic_color
acidity	alkalinity
acquaintance	stranger
acquittal	conviction
acrocarp	pleurocarp
act	refrain
action	inaction
activation	inactivation	deactivation
activator	inhibitor
active	stative	extinct	inactive	passive	quiet	dormant
active_trust	passive_trust
active_voice	passive_voice
activeness	inactiveness
activity	inactivity
actual_sin	original_sin
acute	chronic	obtuse
acuteness	obtuseness
adaptability	unadaptability
add	subtract	take_away
addition	subtraction
additive	subtractive
adduct	abduct
adequacy	inadequacy
adhesive	nonadhesive
adience	abience
adjective	substantive
admissibility	inadmissibility
adsorbent	nonadsorbent
adult	juvenile
advance	recede	retreat	back
advantage	disadvantage
advisability	inadvisability
aesthetic	inaesthetic
affectedness	unaffectedness
afferent	efferent
affinity	consanguinity
affirmation	reversal
affirmative	negative
age	rejuvenate
aged	young
agitation	calmness
agnostic	gnostic
agonist	antagonist
agreeableness	disagreeableness
agreement	disagreement
air_mail	surface_mail
alcoholic	nonalcoholic
alert	unalert
alignment	nonalignment
aliquant	aliquot
aliquot	aliquant
alkalinity	acidity
allogamy	autogamy
allopathy	homeopathy
allopatry	sympatry
alterability	unalterability
alternate	opposite
alternating_current	direct_current
altruism	egoism
amateur	professional
ambiguity	unambiguity
ambiversion	introversion	extraversion
anabolism	catabolism
analogue	digital
analphabetic	alphabetic
analysis	synthesis
anamorphism	katamorphism
anaphrodisia	aphrodisia
anapsid	diapsid
anastalsis	peristalsis
ancestor	descendant
anestrus	estrus
anglican	Nonconformist
anglophilia	Anglophobia
anglophobia	Anglophilia
angularity	roundness
animateness	inanimateness
anionic	cationic
anisotropy	isotropy
annual	perennial	biennial
anode	cathode
anovulation	ovulation
answer	question
antagonist	synergist	agonist
antapex	apex
antecedent	subsequent
anterior	posterior
anteriority	posteriority
anti	pro
anti-american	pro-American
anticatalyst	catalyst
anticholinergic	cholinergic
anticyclone	cyclone
antinode	node
antipyretic	pyretic
antiseptic	septic
antitype	type
antonym	synonym
apex	antapex
aphelion	perihelion
aphrodisia	anaphrodisia
aphrodisiac	anaphrodisiac
apoapsis	periapsis
apogee	perigee
apojove	perijove
apolune	perilune
apophatism	doctrine_of_analogy	cataphatism
aposelene	periselene
appearance	disappearance
appetizingness	unappetizingness
applicability	inapplicability
appositeness	inappositeness
appreciation	depreciation
approachability	unapproachability
approbation	disapprobation
appropriateness	inappropriateness
approval	disapproval
aptitude	inaptitude
aptness	inaptness
aquatic	terrestrial	amphibious
arabic_numeral	Roman_numeral
arianism	Athanasianism
arm	disarm
armament	disarmament
arming	disarming
artfulness	artlessness
artifact	natural_object
artificial_language	natural_language
artlessness	artfulness
ascending	descending
ascending_node	descending_node
ascent	descent
assembly	disassembly
assent	dissent
asset	liability
associate	dissociate
association	disassociation
assortative_mating	disassortative_mating
astigmatism	stigmatism
astringent	nonastringent
asymmetry	symmetry
asynchronism	synchronism
asynchronous_operation	synchronous_operation
athanasianism	Arianism
atheism	theism
atomism	holism
atonality	tonality
atonicity	tonicity
attack	defend
attendance	nonattendance
attention	inattention
attentiveness	inattentiveness
attraction	repulsion
attractiveness	unattractiveness
atypicality	typicality
audibility	inaudibility
audible	inaudible
augmentation	diminution
aunt	uncle
auspiciousness	inauspiciousness
autogamy	allogamy
automatic	manual
autumnal_equinox	vernal_equinox
availability	unavailability
away_game	home_game
awkwardness	gracefulness
back	veer	ahead	front	advance
back_burner	front_burner
background	foreground
backhand	forehand
bad	good
bad_egg	good_egg
bad_guy	good_guy
bad_luck	good_luck
bad_person	good_person
bad_weather	good_weather
badness	goodness
balance	imbalance	unbalance
bar	unbar
basic	incidental
bear	bull
bearing	nonbearing
beauty	ugliness
becomingness	unbecomingness
begin	end
beginning	middle	end	ending
being	nonbeing
belief	unbelief
belt	unbelt
bend	straighten	unbend
beneficence	maleficence
benevolence	malevolence
benignancy	malignancy
benignity	malignity
best	worst
better	worse	worsen
biennial	annual	perennial
bigness	littleness
bind	unbind
biodegradable_pollution	nonbiodegradable_pollution
biped	quadruped
birth	death
bisexual	homosexual	heterosexual
bivalve	univalve
black	white
blame	absolve
blind	sighted
block	unblock
blond	brunet
blunt_file	taper_file
blur	focus
boarding_school	day_school
boil	freeze
bold	timid
boldness	timidity
bolt	unbolt
boo	applaud
bore	interest
born	unborn
borrower	lender
bottom	side	top
bounce	clear
bound	free	unbound
box	unbox
boy	girl
boycott	patronize	patronise
brachycephalic	dolichocephalic
braid	unbraid
brand-name_drug	generic_drug
brave	cowardly	timid
break	repair	make	keep
breakable	unbreakable
breakableness	unbreakableness
breathing	breathless
bridle	unbridle
brightness	dullness
broad-mindedness	narrow-mindedness
brother	sister
brunet	blond
buckle	unbuckle
bull	bear
burden	unburden
button	unbutton
buy	sell
cacodemon	eudemon
call_option	put_option
calm	stormy	agitate
calmness	agitation
capability	incapability
capableness	incapableness
capacity	incapacity
capitalism	socialism
captor	liberator
cardinal	ordinal
carefulness	carelessness
carelessness	carefulness
carinate	ratite
cash	credit
cash_account	margin_account
cash_basis	accrual_basis
catabolism	anabolism
catalectic	acatalectic	hypercatalectic
catalyst	anticatalyst
cataphatism	doctrine_of_analogy	apophatism
catarrhine	platyrrhine	leptorrhine
categorem	syncategorem
categoreme	syncategoreme
cathode	anode
caudate	acaudate
caution	incaution
cautious	incautious
cenobite	eremite
cenogenesis	palingenesis
center	left	right
central	peripheral
centrality	marginality
centralization	decentralization
centrifugal_force	centripetal_force
centripetal_force	centrifugal_force
ceremoniousness	unceremoniousness
certainty	uncertainty
chain	unchain
change	stay
changeableness	changelessness
changelessness	changeableness
characteristic	uncharacteristic
charge	pay_cash	discharge
cheer	complain
cheerfulness	uncheerfulness	cheerlessness
cheerlessness	cheerfulness
child	parent
christian	unchristian
chromatic_color	achromatic_color
circumstantial_evidence	direct_evidence
cisc	RISC
citizen	noncitizen
civil_law	international_law
civilian	serviceman	military
civility	incivility
claim	disclaim	forfeit
clarity	obscurity	opacity
clasp	unclasp
classical	nonclassical
classicism	Romanticism
classicist	romanticist
classification	declassification
classified	unclassified
clean	dirty	unclean
cleanliness	uncleanliness
cleanness	dirtiness
clear	opaque	cloudy	unclear	bounce
clearness	unclearness
clergy	laity
clergyman	layman
clip	unclip
clog	unclog
close	open	distant
closed_chain	open_chain
closed_circuit	open_circuit
closed_interval	open_interval
closeness	openness
closing	opening
clutter	unclutter
cognizance	incognizance
coherence	incoherence
coil	uncoil
cold	hot
cold_war	hot_war
coldness	hotness
collateral	lineal
collective	distributive
color	colorlessness	discolor	black-and-white
colored	uncolored
colorlessness	color
combustible	noncombustible
come	go
comedy	tragedy
comfort	discomfort
commercial	noncommercial
common	uncommon	individual
common_noun	proper_noun
commonality	individuality
commonness	uncommonness
communicativeness	uncommunicativeness
compact	loose
compatibility	incompatibility
competence	incompetence
competition	cooperation
completeness	incompleteness
complex	simple
complex_instruction_set_computer	reduced_instruction_set_computer
complex_instruction_set_computing	reduced_instruction_set_computing
complexity	simplicity
compliance	noncompliance
composure	discomposure
compound	simple
comprehensibility	incomprehensibility
comprehension	incomprehension
comprehensive	noncomprehensive
compress	decompress
compressibility	incompressibility
compression	decompression
con	pro
concave_polygon	convex_polygon
concealing	revealing
conceit	humility
concentrate	deconcentrate
concentration	dilution	distribution
concentricity	eccentricity
conception	misconception
concern	unconcern
conclusiveness	inconclusiveness
concrete	abstract
concreteness	abstractness
conductor	insulator
confidence	diffidence
conformism	nonconformism
conformist	nonconformist
conformity	nonconformity
congeniality	uncongeniality
congruity	incongruity
congruousness	incongruousness
conjunctive	disjunctive
connectedness	disconnectedness	unconnectedness
consanguinity	affinity
conscientiousness	unconscientiousness
consciousness	unconsciousness
consequence	inconsequence
conservative	liberal
conserve	waste
consideration	inconsideration
consistency	inconsistency
consonant	vowel
conspicuousness	inconspicuousness
constancy	inconstancy
constant	inconstant
constitutional	unconstitutional
construction	misconstruction
constructiveness	destructiveness
consumptive	generative
contamination	decontamination
content	discontent
contentment	discontentment
continent	incontinent
continuance	discontinuance
continuant_consonant	stop_consonant
continuation	discontinuation
continuity	discontinuity
contract	expand
contraction	expansion
contraindication	indication
convenience	inconvenience
conventionality	unconventionality
convergence	divergence
convergency	divergency
convergent_thinking	divergent_thinking
convertibility	inconvertibility
convertible	inconvertible
convex_polygon	concave_polygon
convict	acquit
conviction	acquittal
cooking_apple	eating_apple
cool	warm	heat
cooperation	competition
cooperative	uncooperative
coordination	incoordination
cork	uncork
corporeality	incorporeality
corpuscular_theory	wave_theory
corpuscular_theory_of_light	wave_theory_of_light
correctness	incorrectness
corruptibility	incorruptibility
corruptness	incorruptness
cortex	medulla
cosmopolitan	provincial	endemic
counterfactuality	factuality
counterfeit	genuine
counterrevolutionary	revolutionary
couple	uncouple
courage	cowardice
courtesy	discourtesy
cover	uncover
covert	overt
cowardice	courage
crate	uncrate
creativeness	uncreativeness
credibility	incredibility
credit	cash	debit
creditor	debtor
crescendo	decrescendo
criminalisation	decriminalisation
criminalization	decriminalization
crookedness	straightness
cross	uncross
cross-fertilization	self-fertilization
cross-pollination	self-pollination
cry	laugh
cryptogamia	Phanerogamae
cultivated_plant	weed
curability	incurability
curableness	incurableness
curliness	straightness
current	noncurrent
curse	bless
curve	straight_line
custom-made	ready-made
cut	uncut
cyclone	anticyclone
dabbling_duck	diving_duck
danger	safety
dangerousness	safeness
dark	light
darkness	lightness
daughter	son
day	night
day_game	night_game
day_school	boarding_school	night_school
deactivation	activation
dead	alive	living	live
deaf	hearing
death	birth
debit	credit
debtor	creditor
deceleration	acceleration
decency	indecency
decentralization	centralization
deciduous_plant	evergreen_plant
decision	indecision
decisiveness	indecisiveness
declarative	interrogative
declassification	classification
decline	improvement
decompression	compression
decontamination	contamination
decorousness	indecorousness
decorum	indecorum
decrease	increase
decrement	increment
decrescendo	crescendo
decriminalisation	criminalisation
decriminalization	criminalization
dedicated_file_server	non-dedicated_file_server
deductible	nondeductible
deep	shallow
deepness	shallowness
default	pay_up
defeat	victory
defeated	undefeated
defence	offence
defendant	plaintiff
defense	offense	prosecution
defensive	offensive
deficit	lead
deflation	disinflation	inflation
deflationary_spiral	inflationary_spiral
delay	rush
demand	supply
demerit	merit
demobilization	mobilization
demonetization	monetization
demonstrative	undemonstrative
demotion	promotion
denationalization	nationalization
dependability	undependability
dependableness	undependableness
dependent	independent
depigmentation	pigmentation
deposit	withdraw
depreciation	appreciation
depressant	stimulative
depression	elation
descendant	ancestor
descending_node	ascending_node
descent	ascent
descriptive_linguistics	prescriptive_linguistics
desirability	undesirability
despair	hope
destabilisation	stabilisation
destabilization	stabilization
destructibility	indestructibility
destructiveness	constructiveness
desynchronization	synchronization
desynchronizing	synchronizing
detribalisation	tribalisation
detribalization	tribalization
development	nondevelopment
deviate	conform
devolution	evolution
dextrorotation	levorotation
diapsid	anapsid
die	be_born
difference	sameness
difficulty	ease
diffidence	confidence
digestibility	indigestibility
digitigrade	plantigrade
digitigrade_mammal	plantigrade_mammal
dilution	concentration
diminution	augmentation
diploid	polyploid	haploid
direct_current	alternating_current
direct_discourse	indirect_discourse
direct_evidence	circumstantial_evidence
directness	indirectness
dirtiness	cleanness
disadvantage	advantage
disagreeableness	agreeableness
disagreement	agreement
disappearance	appearance
disapprobation	approbation
disapproval	approval
disarmament	armament
disarming	arming
disassembly	assembly
disassociation	association
disassortative_mating	assortative_mating
discharge	charge	enlist
discipline	indiscipline
discomfort	comfort
discomposure	composure
disconnect	connect
disconnectedness	connectedness
discontent	content
discontentment	contentment
discontinuance	continuance
discontinuation	continuation
discontinuity	continuity
discouragement	encouragement
discourtesy	courtesy
disembarkation	embarkation
disembarrassment	embarrassment
disenfranchisement	enfranchisement
disequilibrium	equilibrium
disesteem	esteem
disfluency	fluency
dishonesty	honesty
dishonor	honor
dishonorableness	honorableness
disincentive	incentive
disinclination	inclination
disinflation	deflation	inflation
disingenuousness	ingenuousness
dislike	like	liking
disloyalty	loyalty
disobedience	obedience
disorder	order
disorderliness	orderliness
dispensability	indispensability
dispensableness	indispensableness
disposable	nondisposable
disproportion	proportion
disreputability	reputability
disrepute	repute
disrespect	respect
dissatisfaction	satisfaction
dissent	assent
disservice	service
dissimilarity	similarity
dissimilitude	similitude
dissonance	harmony
dissuasion	persuasion
distinctness	indistinctness
distributary	tributary
distribution	concentration
distrust	trust
disunion	union
divergence	convergence
divergency	convergency
divergent_thinking	convergent_thinking
divide	unite	multiply
diving_duck	dabbling_duck
dock	undock
doctrine_of_analogy	apophatism	cataphatism
dolichocephalic	brachycephalic
domestic	undomestic	foreign
domestic_flight	international_flight
dominant	recessive	subordinate
double	single
dove	hawk
dovishness	hawkishness
down	up
downgrade	upgrade
downstage	upstage
downtick	uptick
downtime	uptime
downtown	uptown
draftee	volunteer
dress	undress
drinkable	undrinkable
drinker	nondrinker
driver	nondriver
drunkenness	soberness
dry	sweet	phlegmy	wet
dry-bulb_thermometer	wet-bulb_thermometer
dry_fly	wet_fly
dry_season	rainy_season
dryness	wetness
due	undue
dullness	sharpness	brightness
dumb_bomb	smart_bomb
dying	nascent
dynamic	undynamic
dysgenics	eugenics
dysphemism	euphemism
dysphoria	euphoria
dystopia	utopia
e-mail	snail_mail
eager	uneager
earliness	lateness
earned_run	unearned_run
ease	difficulty
east	west
easterly	westerly
easy_money	tight_money
eating_apple	cooking_apple
ebb	tide
ebbtide	flood_tide
eccentric	concentric
eccentricity	concentricity
edible	inedible
effectiveness	ineffectiveness
effector	receptor
efferent	afferent
efficacy	inefficacy
efficiency	inefficiency
efflux	influx
effortfulness	effortlessness
effortlessness	effortfulness
egalitarian	elitist
egoism	altruism
egress	ingress
elastic	inelastic
elasticity	inelasticity
elation	depression
elective	appointive
electrolytic_cell	voltaic_cell
electronic_mail	snail_mail
elegance	inelegance
eligibility	ineligibility
elitist	egalitarian
email	snail_mail
embarkation	disembarkation
embarrassment	disembarrassment
emersion	immersion
emotional_person	unemotional_person
emotionality	unemotionality
employable	unemployable
employee	employer
employer	employee
employment	unemployment
emptiness	fullness
empty	full	fill
encouragement	discouragement
end	beginning	middle	begin
endemic	ecdemic	cosmopolitan	epidemic
ending	beginning
endocrine	exocrine
endogamy	exogamy
endotoxin	exotoxin
enfranchisement	disenfranchisement
engagement	non-engagement
enlightened	unenlightened
enlightenment	unenlightenment
environmentalism	hereditarianism
epidemic	endemic	ecdemic
equal	differ	unequal
equality	inequality
equatorial	polar
equilibrium	disequilibrium
equity	inequity
equivalence	nonequivalence
equivocalness	unequivocalness
eremite	cenobite
errancy	inerrancy
essential	inessential
essentiality	inessentiality
esteem	disesteem
estrus	anestrus
eudemon	cacodemon
eugenics	dysgenics
eukaryote	prokaryote
euphemism	dysphemism
euphoria	dysphoria
even	uneven	odd
even-toed_ungulate	odd-toed_ungulate
evenness	unevenness
evergreen	deciduous
evergreen_plant	deciduous_plant
evil	good
evilness	goodness
evolution	devolution
exactness	inexactness
exchangeability	unexchangeability
exclusion	inclusion
exclusive	inclusive
existence	nonexistence
exit	enter
exocrine	endocrine
exogamy	endogamy
exon	intron
exotoxin	endotoxin
expansion	contraction
expatriate	repatriate
expectedness	unexpectedness
expedience	inexpedience
expediency	inexpediency
expedient	inexpedient
expensiveness	inexpensiveness
experience	inexperience
expert_witness	lay_witness
explicitness	inexplicitness
explosive	nonexplosive
export	import
express	local
extension	flexion
extensor	flexor
exterior	interior
external	internal
extraordinariness	ordinariness
extraversion	introversion	ambiversion
extrovert	introvert
factuality	counterfactuality
failing	passing
failure	success
faintheartedness	stoutheartedness
fair	unfair	foul
fair_ball	foul_ball
fairness	unfairness
faithful	unfaithful
faithfulness	unfaithfulness
fall	rise
fallibility	infallibility
falsehood	truth
falsity	truth
fame	infamy
familiar	strange	unfamiliar
familiarity	unfamiliarity
fancy	plain
far	near
farness	nearness
fast	slow
fast_lane	slow_lane
fast_reactor	thermal_reactor
fat	thin
fat_person	thin_person
father	mother
fatness	leanness
fatty	nonfat
fauna	flora
favorableness	unfavorableness
fear	fearlessness
fearfulness	fearlessness
fearlessness	fearfulness	fear
feasibility	infeasibility
federal	unitary
feed	starve
felicity	infelicity
female	androgynous	male
female_aristocrat	male_aristocrat
female_child	male_child
female_monarch	male_monarch
female_offspring	male_offspring
female_parent	male_parent
female_sibling	male_sibling
femaleness	maleness
feminine	neuter	masculine
femininity	masculinity
fertility	infertility
few	many
fidelity	infidelity
figure	ground
fill	empty
find	lose
fine	coarse
finish	start
finiteness	infiniteness
fire	hire
first	second	last
fit	unfit
fitness	unfitness
fixed-width_font	proportional_font
fixedness	looseness
flash-forward	flashback
flashback	flash-forward
flat	contrasty	sharp	natural
flexibility	inflexibility
flexion	extension
flexor	extensor
float	sink
flood_tide	ebbtide
flora	fauna
flowering	flowerless
fluency	disfluency
focus	blur
foe	friend
fold	unfold
follower	leader
following	leading
folly	wisdom
foot	head
fore	aft
foreground	background
forehand	backhand
foreignness	nativeness
forfeit	claim
formal	informal
formalism	imitation
formality	informality
former	latter
forte	piano
fortissimo	pianissimo
forward	reverse	backward
foul	fair
foul_ball	fair_ball
found	lost
frail	robust
free	unfree	obstruct	bound	confine
free_state	slave_state
freelance	salaried
freeze	unfreeze	boil
fresh_water	saltwater
freshness	staleness
friend	foe
friendliness	unfriendliness
friendly	hostile	unfriendly
frivolity	seriousness
front	rear	back
front_burner	back_burner
fruitfulness	fruitlessness
fruitlessness	fruitfulness
full	empty	thin
fullness	emptiness
function	malfunction
functional_disorder	organic_disorder
functioning	malfunctioning
fuse	defuse
future	present	past
futurity	pastness	presentness
gain	loss	fall_back	reduce
gather	spread
general	specific	particular	local
general_agent	special_agent
general_verdict	special_verdict
generalist	specialist
generality	particularity
generic	varietal
generic_drug	brand-name_drug
generic_wine	varietal_wine
generosity	stinginess
genuineness	spuriousness
girl	boy
give	take
glad	sad
gnostic	agnostic
go	no-go	come
godliness	ungodliness
good	bad	evil
good_egg	bad_egg
good_fortune	misfortune
good_guy	bad_guy
good_health	ill_health
good_humor	ill_humor
good_luck	bad_luck
good_nature	ill_nature
good_part	weak_part
good_person	bad_person
good_weather	bad_weather
goodness	evilness	badness
gracefulness	awkwardness
graciousness	ungraciousness
gradual	sudden	steep
gradualness	abruptness
grand_larceny	petit_larceny
granter	withholder
gratitude	ingratitude
gravitation	levitation
gravity	levity
green	ripe
greenness	ripeness
gross	net
ground	figure
ground_stroke	volley
guilt	innocence
gutlessness	gutsiness
gutsiness	gutlessness
hairiness	hairlessness
hairlessness	hairiness
half	whole
hand_mower	power_mower
haploid	diploid	polyploid
happiness	sadness	unhappiness
hard_drug	soft_drug
hard_water	soft_water
hardball	softball
hardness	softness
hardware	software
harmonic	nonharmonic
harmony	dissonance
harness	unharness
hate	love
have	lack
hawk	dove
hawkishness	dovishness
head	foot	rear	tail
healthfulness	unhealthfulness
hearing	deaf
heat	cool
heaven	Hell
heaviness	lightness
heavy	light
heedfulness	heedlessness
heedlessness	heedfulness
heir_apparent	heir_presumptive
heir_presumptive	heir_apparent
hell	Heaven
here	there
hereditarianism	environmentalism
hereness	thereness
heterocercal_fin	homocercal_fin
heterodactyl_foot	zygodactyl_foot
heterogeneity	homogeneity
heterosexual	bisexual	homosexual
heterozygosity	homozygosity
heuristic	algorithmic
hide	show
high	low_spirits	low
high-rise	low-rise
high_explosive	low_explosive
high_pitch	low_pitch
high_quality	low_quality
high_relief	low_relief
high_sea	territorial_waters
high_season	off-season
high_status	low_status
high_tide	low_tide
highland	lowland
highness	lowness
hire	fire
hit	miss
hitch	unhitch
hold	let_go_of
holiness	unholiness
holism	atomism
hollow	solid
hollowness	solidity
holy	unholy
home	away
home_game	away_game
homeopathy	allopathy
homocercal_fin	heterocercal_fin
homogeneity	heterogeneity
homosexual	bisexual	heterosexual
homozygosity	heterozygosity
honesty	dishonesty
honor	dishonor
honorableness	dishonorableness
hook	unhook
hope	despair
hopeful	hopeless
hopefulness	hopelessness
hopelessness	hopefulness
horizontal	vertical	inclined
hospitableness	inhospitableness
hospitality	inhospitality
host	parasite
hostile	friendly	amicable
hot_war	cold_war
hotness	coldness
human	nonhuman
humaneness	inhumaneness
humility	pride	conceit
husband	wife
hydrate	dehydrate
hypercalcemia	hypocalcemia
hypercapnia	hypocapnia
hypercatalectic	acatalectic	catalectic
hyperglycemia	hypoglycemia
hyperkalemia	hypokalemia
hypernatremia	hyponatremia
hyperopia	myopia
hyperparathyroidism	hypoparathyroidism
hyperpigmentation	hypopigmentation
hyperpnea	hypopnea
hypersomnia	insomnia
hypertension	hypotension
hypertensive	normotensive	hypotensive
hyperthermia	hypothermia
hyperthyroidism	hypothyroidism
hypertonia	hypotonia
hypertonicity	hypotonicity
hypertonus	hypotonus
hypervolemia	hypovolemia
hypocalcemia	hypercalcemia
hypocapnia	hypercapnia
hypoglycemia	hyperglycemia
hypokalemia	hyperkalemia
hyponatremia	hypernatremia
hypoparathyroidism	hyperparathyroidism
hypopigmentation	hyperpigmentation
hypopnea	hyperpnea
hypotension	hypertension
hypotensive	hypertensive	normotensive
hypothermia	hyperthermia
hypothyroidism	hyperthyroidism
hypotonia	hypertonia
hypotonicity	hypertonicity
hypotonus	hypertonus
hypovolemia	hypervolemia
idle	work	busy	run
ill	well
ill-being	well-being
ill_health	good_health
ill_humor	good_humor
ill_nature	good_nature
illegality	legality
illegibility	legibility
illegitimacy	legitimacy
illegitimate	legitimate
illiberality	liberality
illicitness	licitness
illiteracy	literacy
illiterate	literate
illness	wellness
illogicality	logicality
illogicalness	logicalness
imbalance	balance
imitation	formalism
immateriality	materiality
immaturity	maturity
immediacy	mediacy
immersion	emersion
immobility	mobility
immoderation	moderation
immodesty	modesty
immorality	morality
immortal	mortal
immortality	mortality
immotility	motility
immovability	movability
immovableness	movableness
immunocompetence	immunodeficiency
immunodeficiency	immunocompetence
immutability	mutability
immutableness	mutableness
impalpability	palpability
impartiality	partiality
impatience	patience
impenetrability	penetrability
imperative	beseeching
imperceptibility	perceptibility
imperfect	perfect
imperfectibility	perfectibility
imperfection	perfection
impermanence	permanence
impermeability	permeability
impermissibility	permissibility
imperviousness	perviousness
impiety	piety
implausibility	plausibility
impoliteness	politeness
imponderable	ponderable
import	export
importance	unimportance
impossibility	possibility
impossible	possible
impotence	potence
impotency	potency
impracticability	practicability
impracticableness	practicableness
impracticality	practicality
impreciseness	preciseness
imprecision	precision
improbability	probability
improperness	properness
impropriety	propriety
improvement	decline
improvidence	providence
imprudence	prudence
impurity	purity
in-basket	out-basket
inability	ability
inaccessibility	accessibility
inaccuracy	accuracy
inaction	action
inactivation	activation
inactiveness	activeness
inactivity	activity
inadequacy	adequacy
inadmissibility	admissibility
inadvisability	advisability
inanimateness	animateness
inapplicability	applicability
inappositeness	appositeness
inappropriateness	appropriateness
inaptitude	aptitude
inaptness	aptness
inattention	attention
inattentiveness	attentiveness
inaudibility	audibility
inaugural	exaugural
inauspiciousness	auspiciousness
incapability	capability
incapableness	capableness
incapacity	capacity
incaution	caution
incentive	disincentive
incidental	basic
incivility	civility
inclination	disinclination
inclusion	exclusion
incognizance	cognizance
incoherence	coherence
income	outgo
incoming	outgoing
incompatibility	compatibility
incompetence	competence
incompetent	competent
incompleteness	completeness
incomprehensibility	comprehensibility
incomprehension	comprehension
incompressibility	compressibility
inconclusiveness	conclusiveness
incongruity	congruity
incongruousness	congruousness
inconsequence	consequence
inconsideration	consideration
inconsistency	consistency
inconspicuousness	conspicuousness
inconstancy	constancy
inconvenience	convenience
inconvertibility	convertibility
incoordination	coordination
incorporeality	corporeality
incorrectness	correctness
incorruptibility	corruptibility
incorruptness	corruptness
increase	decrease
incredibility	credibility
increment	decrement
incurability	curability
incurable	curable
incurableness	curableness
indecency	decency
indecision	decision
indecisiveness	decisiveness
indecorousness	decorousness
indecorum	decorum
independent	dependent
indestructibility	destructibility
indication	contraindication
indigestibility	digestibility
indirect_discourse	direct_discourse
indirectness	directness
indiscipline	discipline
indispensability	dispensability
indispensableness	dispensableness
indistinctness	distinctness
individual	common
individuality	commonality
ineffectiveness	effectiveness
inefficacy	efficacy
inefficiency	efficiency
inelasticity	elasticity
inelegance	elegance
ineligibility	eligibility
inequality	equality
inequity	equity
inerrancy	errancy
inessential	essential
inessentiality	essentiality
inevitable	evitable
inexactness	exactness
inexpedience	expedience
inexpediency	expediency
inexpensiveness	expensiveness
inexperience	experience
inexplicitness	explicitness
infallibility	fallibility
infamy	fame
infeasibility	feasibility
infelicity	felicity
inferior	superior
inferiority	superiority
infernal	supernal
infertility	fertility
infidelity	fidelity
infield	outfield
infinite	finite
infiniteness	finiteness
inflation	deflation	disinflation
inflationary_spiral	deflationary_spiral
inflexibility	flexibility
inflow	outflow
influx	efflux
informality	formality
ingenuousness	disingenuousness
ingratitude	gratitude
ingress	egress
inhibitor	activator
inhospitableness	hospitableness
inhospitality	hospitality
inhumaneness	humaneness
initiate	uninitiate
injudiciousness	judiciousness
injustice	justice
innocence	guilt
innocent	guilty
inopportuneness	opportuneness
inpatient	outpatient
inquiring	uninquiring
insalubriousness	salubriousness
insalubrity	salubrity
insanity	sanity
insecureness	secureness
insecurity	security
insensibility	sensibility
insensitiveness	sensitiveness
insensitivity	sensitivity
insentience	sentience
inside	outside
insignificance	significance
insincerity	sincerity
insolubility	solubility
insolvency	solvency
insolvent	solvent
insomnia	hypersomnia
instability	stability
insubordination	subordination
insubstantiality	substantiality
insufficiency	sufficiency
insulator	conductor
insurability	uninsurability
insured	uninsured
intangibility	tangibility
intangible	tangible
integration	segregation
intellectual	nonintellectual
intelligence	stupidity
intelligibility	unintelligibility
intemperance	temperance
intensive	extensive
interest	bore
interestingness	uninterestingness
interference	noninterference
interior	exterior
intermediate	terminal
international	national
international_flight	domestic_flight
international_law	civil_law
international_waters	territorial_waters
internationalism	nationalism
interrogative	declarative
interrogatory	declaratory
interstate	intrastate
intervention	nonintervention
intolerance	tolerance
intractability	tractability
intransitive	transitive
intransitivity	transitivity
intron	exon
introversion	ambiversion	extraversion
introvert	extrovert
inutility	utility
invalid	valid
invariability	variability
invariable	variable
invariableness	variableness
inverse	direct
invertebrate	vertebrate
invisibility	visibility
involvement	non-involvement
invulnerability	vulnerability
inwardness	outwardness
ionic	nonionic
irrational	rational
irregular	regular
irregularity	regularity
irrelevance	relevance
irresoluteness	resoluteness
irresponsibility	responsibility
irresponsibleness	responsibleness
irreverence	reverence
irreversibility	reversibility
irreversible_process	reversible_process
isometric	isotonic
isotropy	anisotropy
issue	recall
join	disjoin
joint	separate
joy	sorrow
judgment_in_personam	judgment_in_rem
judgment_in_rem	judgment_in_personam
judiciousness	injudiciousness
junior	senior
justice	injustice
juvenile	adult
katamorphism	anamorphism
keep	break	lose
kern	kern
kinanesthesia	kinesthesia
kind	unkind
kindness	unkindness
kinesthesia	kinanesthesia
king	queen
knot	unknot
know	ignore
lady	Lord
laity	clergy
larboard	starboard
large	small
largeness	smallness
lash	unlash
last	first
lateness	earliness
latter	former
laugh	cry
lawfulness	unlawfulness
laxative	costive
lay_witness	expert_witness
layman	clergyman
lead	deficit
leaded_gasoline	unleaded_gasoline
leader	follower
leading	following
lean	rich
leanness	fatness
least	most
leave	arrive
leeward	windward
left	center	right
legality	illegality
legibility	illegibility
legitimacy	illegitimacy
lender	borrower
let	prevent
level	raise
levitation	gravitation
levity	gravity
levorotation	dextrorotation
liability	asset
liar	square_shooter
liberal	conservative
liberality	illiberality
liberator	captor
libertarian	necessitarian
licitness	illicitness
lie	sit	stand
light	dark	heavy
lightness	darkness	heaviness
like	unlike	dislike
likelihood	unlikelihood
likeliness	unlikeliness
likeness	unlikeness
liking	dislike
limited	unlimited
liquid	solid	gaseous
listed_security	unlisted_security
literacy	illiteracy
literal	figurative
literate	illiterate
little	big	much
littleness	bigness
live_birth	stillbirth
liveborn_infant	stillborn_infant
living	dead
loading	unloading
local	national	express	general
location	studio
lock	unlock
lodge	dislodge
logicality	illogicality
logicalness	illogicalness
longness	shortness
looseness	fixedness	tightness
loosening	tightening
lord	Lady
loser	achiever	winner
losings	winnings
loss	gain
lost	saved	won	found
loudness	softness
love	hate
low	high
low_explosive	high_explosive
low_pitch	high_pitch
low_quality	high_quality
low_relief	high_relief
low_spirits	high
low_status	high_status
low_tide	high_tide
lower	raise
lowercase	uppercase
lowland	highland	upland
lowness	highness
loyalty	disloyalty
lumper	splitter
lyric	dramatic
major	minor
major_surgery	minor_surgery
majority	minority
majuscule	minuscule
make	break	unmake
male	female	androgynous
male_aristocrat	female_aristocrat
male_child	female_child
male_monarch	female_monarch
male_offspring	female_offspring
male_parent	female_parent
male_sibling	female_sibling
maleficence	beneficence
maleness	femaleness
malevolence	benevolence
malfunction	function
malignancy	benignancy
malignity	benignity
malleability	unmalleability
malted	unmalted
man	woman
manual	automatic
margin_account	cash_account
marginality	centrality
market_economy	non-market_economy
married	unmarried
masculine	neuter	feminine
masculinity	femininity
mask	unmask
masochist	sadist
material	immaterial
materiality	immateriality
maturity	immaturity
maxi	midi	mini
maximization	minimization
maximum	minimum
meaningfulness	meaninglessness
meaninglessness	meaningfulness
mediacy	immediacy
medical	surgical
medulla	cortex
member	nonmember
mendacity	veracity
mental_health	mental_illness
mental_illness	mental_health
mercifulness	mercilessness
mercilessness	mercifulness
merit	demerit
merit_system	spoils_system
metallic	nonmetallic
middle	beginning	late	early	end
midi	maxi	mini
military	unmilitary	civilian
mind	forget
mindfulness	unmindfulness
mini	midi	maxi
minimization	maximization
minimum	maximum
minor	major
minor_surgery	major_surgery
minority	majority
minus	plus
minuscule	majuscule
misconception	conception
misconstruction	construction
misfortune	good_fortune
misogyny	philogyny
miss	attend	hit	have
mistrust	trust
mobile	immobile	stabile
mobility	immobility
mobilization	demobilization
moderate	immoderate
moderation	immoderation
modern	nonmodern	old_style
modesty	immodesty
molar	molecular
monetization	demonetization
monism	pluralism
monolingual	multilingual
monophonic_music	polyphonic_music
monophony	polyphony
monosemy	polysemy
monotheism	polytheism
moral	immoral
morality	immorality
more	fewer	less
mortal	immortal
mortal_sin	venial_sin
mortality	immortality
mother	father
motility	immotility
motion	motionlessness
motionlessness	motion
movability	immovability
movableness	immovableness
move	stay	stand_still
much	little
multiculturalism	nationalism
multidimensional_language	one-dimensional_language
multiple	single
mushroom	toadstool
musical	unmusical
mutability	immutability
mutableness	immutableness
muzzle	unmuzzle
myopia	hyperopia
nadir	zenith
naivete	sophistication
narrow	widen	wide
narrow-mindedness	broad-mindedness
narrowing	widening
narrowness	wideness
nastiness	niceness
national	international	local
nationalism	internationalism	multiculturalism
nationalization	denationalization
native	adopted	nonnative	foreign
nativeness	foreignness
natural	unnatural	sharp	supernatural	flat	artificial
natural_depression	natural_elevation
natural_elevation	natural_depression
natural_language	artificial_language
natural_object	artifact
naturalness	unnaturalness
nay	yea
neap_tide	springtide
nearness	farness
necessary	unnecessary
necessitarian	libertarian
negative	affirmative	positive	neutral
negative_charge	positive_charge
negativeness	positiveness
negativity	positivity
neglect	attend_to
neighborliness	unneighborliness
nephew	niece
net	gross
neurotic	unneurotic
neurotic_depression	psychotic_depression
neuter	masculine	feminine
neutral	negative	positive
newness	oldness
nice	nasty
niceness	nastiness
niece	nephew
night	day
night_game	day_game
night_school	day_school
no	yes	some	all
noble	ignoble	lowborn
nobleman	noblewoman
noblewoman	nobleman
node	antinode
nominal	real
nominative	oblique
non-dedicated_file_server	dedicated_file_server
non-engagement	engagement
non-involvement	involvement
non-market_economy	market_economy
non-proliferation	proliferation
non-volatile_storage	volatile_storage
nonabsorbency	absorbency
nonalignment	alignment
nonattendance	attendance
nonbeing	being
nonbiodegradable_pollution	biodegradable_pollution
noncitizen	citizen
noncompliance	compliance
nonconformism	conformism
nonconformist	conformist	Anglican
nonconformity	conformity
nondevelopment	development
nondrinker	drinker
nondriver	driver
nonequivalence	equivalence
nonexistence	existence
noninterference	interference
nonintervention	intervention
nonmember	member
nonobservance	observance
nonparticipation	participation
nonpartisan	partisan
nonpayment	payment
nonproliferation	proliferation
nonreligious_person	religious_person
nonresident	resident
nonsingular_matrix	singular_matrix
nonsmoker	smoker
nonsteroidal	steroidal
nonuniformity	uniformity
nonvolatile_storage	volatile_storage
nonworker	worker
normal	abnormal	paranormal
normality	abnormality
north	south
northern	southern
northernness	southernness
notice	ignore
obedience	disobedience
object_program	source_program
objective	subjective
oblate	prolate
oblique	parallel	nominative	perpendicular
oblique_angle	right_angle
oblique_triangle	right_triangle
obscurity	prominence	clarity
observance	nonobservance
obtrusiveness	unobtrusiveness
obtuseness	acuteness
obverse	reverse
odd-toed_ungulate	even-toed_ungulate
off-season	high_season
offence	defence
offense	defense
offensive	defensive	inoffensive
official	unofficial
offside	onside
offstage	onstage
old	new	young
old_style	modern
oldness	youngness	newness
one-dimensional_language	multidimensional_language
opacity	transparency	clarity
open	shut	closed	close
open_chain	closed_chain
open_circuit	closed_circuit
open_interval	closed_interval
opening	closing
openness	closeness
operative	inoperative
opportuneness	inopportuneness
opposite	alternate
optimism	pessimism
optimist	pessimist
oral	aboral	anal
order	disorder
orderliness	disorderliness
orderly	disorderly
ordinal	cardinal
ordinariness	extraordinariness
ordinary	extraordinary
organic	functional	inorganic
organic_disorder	functional_disorder
orient	disorient
original	unoriginal
original_sin	actual_sin
originality	unoriginality
orthodoxy	unorthodoxy
otherworldliness	worldliness
out	safe
out-basket	in-basket
outboard	inboard
outdoors	indoors
outfield	infield
outflow	inflow
outgo	income
outlaw	legalize
outpatient	inpatient
outside	inside
outwardness	inwardness
over-the-counter_drug	prescription_drug
over-the-counter_medicine	prescription_medicine
overachievement	underachievement
overbid	underbid
overcast	clear_up
overcharge	undercharge
overestimate	underestimate
overgarment	undergarment
overhead	subsurface	surface
overshoot	undershoot
overstatement	understatement
overtime	regulation_time
ovulation	anovulation
pack	unpack
pain	pleasure
palatability	unpalatability
palingenesis	cenogenesis
palpability	impalpability
paper_loss	paper_profit
paper_profit	paper_loss
parallel	oblique	perpendicular
parallel_operation	serial_operation
parallelogram	trapezium
parasite	host
parent	child
partial	impartial
partiality	impartiality
participation	nonparticipation
particular	universal	general
particular_proposition	universal_proposition
particularity	generality
particulate	nonparticulate
partisan	nonpartisan
pass	fail
passerine	nonpasserine
passing	failing	running
passive	active
passive_trust	active_trust
passive_voice	active_voice
past	present	future
pastness	presentness	futurity
patience	impatience
patient	impatient
payment	nonpayment
peace	war
penalty	reward
penetrability	impenetrability
penitent	impenitent
perceptibility	imperceptibility
perceptiveness	unperceptiveness
perennial	annual	biennial
perfect	imperfect
perfectibility	imperfectibility
perfection	imperfection
periapsis	apoapsis
perigee	apogee
perihelion	aphelion
perijove	apojove
perilune	apolune
peripheral	central
periselene	aposelene
perishable	imperishable
peristalsis	anastalsis
permanence	impermanence
permanent	impermanent
permeability	impermeability
permissibility	impermissibility
permissiveness	unpermissiveness
permit	forbid
perpendicular	parallel	oblique
personal	impersonal
persuasion	dissuasion
persuasiveness	unpersuasiveness
perviousness	imperviousness
pessimism	optimism
pessimist	optimist
petit_larceny	grand_larceny
phanerogamae	Cryptogamia
philogyny	misogyny
pianissimo	fortissimo
piano	forte
piety	impiety
pigmentation	depigmentation
pin	unpin
placental	aplacental
plain	patterned	fancy
plaintiff	defendant
plantigrade	digitigrade
plantigrade_mammal	digitigrade_mammal
platyrrhine	catarrhine	leptorrhine
plausibility	implausibility
pleasantness	unpleasantness
pleasing	displeasing
pleasingness	unpleasingness
pleasure	pain
pleasure_principle	reality_principle
pleurocarp	acrocarp
plural	singular
pluralism	monism
plus	minus
point_of_apoapsis	point_of_periapsis
point_of_periapsis	point_of_apoapsis
pointedness	unpointedness
politeness	impoliteness
political_correctness	political_incorrectness
political_incorrectness	political_correctness
polyphonic_music	monophonic_music
polyphony	monophony
polyploid	diploid	haploid
polysemy	monosemy
polytheism	monotheism
poor	rich
poor_people	rich_people
popularity	unpopularity
porosity	solidity
portable	unportable
positive	negative	neutral
positive_charge	negative_charge
positiveness	negativeness
positivity	negativity
possibility	impossibility
possible	impossible
posterior	anterior
posteriority	priority	anteriority
postmortem	antemortem
potence	impotence
potency	impotency
potential	actual
poverty	wealth
power	powerlessness
power_mower	hand_mower
powerfulness	powerlessness
powerlessness	power	powerfulness
practicability	impracticability
practicableness	impracticableness
practicality	impracticality
praise	criticize
preciseness	impreciseness
precision	imprecision
predictability	unpredictability
prefix	suffix
preparation	resolution
prescription	nonprescription
prescription_drug	over-the-counter_drug
prescription_medicine	over-the-counter_medicine
prescriptive_linguistics	descriptive_linguistics
presence	absence
present	future	absent	past
presentness	pastness	futurity
pretentiousness	unpretentiousness
preventive	permissive
pride	humility
primary	secondary
priority	posteriority
private	public
pro	con	anti
probability	improbability
probable	improbable
productiveness	unproductiveness
professional	unprofessional	nonprofessional	amateur
profit	lose	break_even
profitability	unprofitability
profitableness	unprofitableness
profundity	superficiality
progress	regress
progressive	regressive
prokaryote	eukaryote
proliferation	nonproliferation	non-proliferation
prominence	obscurity
promotion	demotion
pronation	supination
proper_noun	common_noun
properness	improperness
propitiousness	unpropitiousness
proportion	disproportion
proportional_font	fixed-width_font
proprietary	nonproprietary
propriety	impropriety
prosecution	defense
providence	improvidence
provincial	cosmopolitan
prudence	imprudence
psychotic_depression	neurotic_depression
public	private
pull	push
punctuality	tardiness
purebred	crossbred
purge	rehabilitate
purity	impurity
purposefulness	purposelessness
purposelessness	purposefulness
push	pull
put_option	call_option
quadruped	biped
queen	king
question	answer
quiet	unquiet	noisy	active
radial_asymmetry	radial_symmetry
radial_symmetry	radial_asymmetry
radical	cauline
rainy_season	dry_season
raise	level	lower
rational	irrational
ratite	carinate
ravel	unravel
raw	cooked
ready	unready
ready-made	custom-made
real	unreal	nominal
reality	unreality
reality_principle	pleasure_principle
rear	front	head
recall	issue
receptor	effector
recessive	dominant
reciprocal	nonreciprocal
record	erase
recto	verso
reduced_instruction_set_computer	complex_instruction_set_computer
reduced_instruction_set_computing	complex_instruction_set_computing
reentrant_angle	salient_angle
refrain	act
refuse	accept
regress	progress
regular	irregular
regularity	irregularity
regulation_time	overtime
reject	accept	admit
rejection	acceptance
relatedness	unrelatedness
relative	absolute
relevance	irrelevance
reliability	unreliability
reliableness	unreliableness
religious	irreligious	secular
religious_person	nonreligious_person
repair	break
repatriate	expatriate
representative	nonrepresentative
reprobate	approbate
repulsion	attraction
reputability	disreputability
repute	disrepute
requisition	derequisition
resident	nonresident
resoluteness	irresoluteness
resolution	preparation
respect	disrespect
respectability	unrespectability
responsibility	irresponsibility
responsibleness	irresponsibleness
responsiveness	unresponsiveness
rest	be_active
rest_day	workday
restraint	unrestraint
retail	wholesale
retarded	precocious
retreat	advance
retrospective	prospective
revealing	concealing
reverence	irreverence
reversal	affirmation
reverse	forward	obverse
reversibility	irreversibility
reversible	nonreversible	irreversible
reversible_process	irreversible_process
revolutionary	counterrevolutionary
reward	penalty
rich	lean	poor
rich_people	poor_people
ride	walk
right	center	wrongly	wrong	left
right_angle	oblique_angle
right_triangle	oblique_triangle
righteousness	unrighteousness
rightfulness	wrongfulness
rightness	wrongness
ripeness	greenness
risc	CISC
rise	set	fall
rising	falling
rising_trot	sitting_trot
roman_numeral	Arabic_numeral
romanticism	classicism
romanticist	classicist
rotor	stator
rough	smooth
roughness	smoothness
round	square
roundness	angularity
ruminant	nonruminant
run	idle
running	passing	standing
rural_area	urban_area
rush	linger	delay
rusticity	urbanity
saddle	unsaddle
sadist	masochist
sadness	happiness
safe	dangerous	out
safeness	dangerousness
safety	danger
salient	re-entrant
salient_angle	reentrant_angle
saltwater	fresh_water
salubriousness	insalubriousness
salubrity	insalubrity
same	different	other
sameness	difference
sanitariness	unsanitariness
sanity	insanity
satisfaction	dissatisfaction
satisfactoriness	unsatisfactoriness
savory	unsavory
scarcity	abundance
scramble	unscramble
screw	unscrew
scrupulousness	unscrupulousness
seal	unseal
seasonableness	unseasonableness
seasonal	year-round
second	first
secondary	primary
sectarian	nonsectarian
secular	religious
secured_bond	unsecured_bond
secureness	insecureness
security	insecurity
seemliness	unseemliness
segregate	desegregate
segregation	integration
self-consciousness	unselfconsciousness
self-fertilization	cross-fertilization
self-pollination	cross-pollination
selfishness	unselfishness
sell	buy
senior	junior
sensibility	insensibility
sensitive	insensitive
sensitiveness	insensitiveness
sensitivity	insensitivity
sensitizing	desensitizing
sent	unsent
sentience	insentience
separate	joint
separation	union
serial_operation	parallel_operation
seriousness	frivolity
service	disservice
serviceman	civilian
set	rise
shallow	deep
shallowness	deepness
sharp	dull	flat	natural
sharpness	dullness	softness
short	long	tall
shortness	longness	tallness
shout	whisper
show	hide
shrink	stretch
side	bottom	top
significance	insignificance
silence	sound
similarity	dissimilarity
similitude	dissimilitude
simple	complex	compound
simplicity	complexity
sincerity	insincerity
single	double	multiple
singular	plural
singular_matrix	nonsingular_matrix
sink	source	float
sister	brother
sitter	stander
sitting_trot	rising_trot
skillfulness	unskillfulness
skim_milk	whole_milk
slave_state	free_state
sleep	wake
sleepiness	wakefulness
sleeping	waking
slow_lane	fast_lane
small	big	large
smallness	largeness
smart	stupid
smart_bomb	dumb_bomb
smoker	nonsmoker
smooth	roughen	rough
smoothness	roughness
snail_mail	electronic_mail	email	e-mail
snarl	unsnarl
soberness	drunkenness
sociability	unsociability
sociable	unsociable
social	unsocial
socialism	capitalism
soft-finned_fish	spiny-finned_fish
soft_drug	hard_drug
soft_water	hard_water
softball	hardball
softness	sharpness	loudness	hardness
software	hardware
solid	liquid	hollow	gaseous
solidity	hollowness	porosity
solubility	insolubility
solvability	unsolvability
solvency	insolvency
solvent	insolvent
son	daughter
sophistication	naivete
sorrow	joy
sound	unsound	silence
soundness	unsoundness
sour	sweeten	sweet
source	sink
source_program	object_program
south	north
southernness	northernness
sparkling	still
speaking	nonspeaking
special_agent	general_agent
special_verdict	general_verdict
specialist	generalist
specific	nonspecific	general
spell	unspell
spiny-finned_fish	soft-finned_fish
split_ticket	straight_ticket
splitter	lumper
spoils_system	merit_system
spread	gather
springtide	neap_tide
spuriousness	genuineness
square	round
square_shooter	liar
stabile	mobile
stabilisation	destabilisation
stability	instability
stabilization	destabilization
stable	unstable
stableness	unstableness
staleness	freshness
stand	sit	yield	lie
standard	nonstandard
stander	sitter
standing	seated	running
staple	unstaple
starboard	larboard
start	stop	finish
stator	rotor
stay	depart	change	move
steadiness	unsteadiness
steady	unsteady
steep	gradual
stifle	stimulate
stigmatism	astigmatism
still	sparkling	moving	no_longer
stillbirth	live_birth
stillborn_infant	liveborn_infant
stinginess	generosity
stop	start
stop_consonant	continuant_consonant
stoutheartedness	faintheartedness
straight	curly	crooked	curved
straight_line	curve
straight_ticket	split_ticket
straightness	crookedness	curliness
strain	unstrain
stranger	acquaintance
strap	unstrap
stratified_language	unstratified_language
strength	weakness
strengthening	weakening
stretch	shrink
string	unstring
strong_point	weak_point
studio	location
stuff	unstuff
stupid	smart
stupidity	intelligence
submersible	nonsubmersible	surface_ship
subordinate	insubordinate	dominant
subordination	insubordination
subscript	superscript	adscript
substantiality	insubstantiality
substantive	adjective
subtraction	addition
success	failure
sufficiency	insufficiency
suffix	prefix
suitability	unsuitability
suitableness	unsuitableness
summer_solstice	winter_solstice
sunrise	sunset
sunset	sunrise
superficiality	profundity
superior	inferior
superiority	inferiority
supernatural	natural
superscript	subscript	adscript
supination	pronation
supply	demand
surface	subsurface	overhead
surface_mail	air_mail
surface_ship	submersible
surrender	resist
susceptibility	unsusceptibility
sweet	sour	dry
symmetry	asymmetry
sympatry	allopatry
syncategorem	categorem
syncategoreme	categoreme
synchronism	asynchronism
synchronization	desynchronization
synchronizing	desynchronizing
synchronous_operation	asynchronous_operation
synergist	antagonist
synonym	antonym
synthesis	analysis
synthetic	analytic
table_d'hote	a_la_carte
tactfulness	tactlessness
tactlessness	tactfulness
tail	head
take	give
talk	keep_quiet
tall	short
tallness	shortness
tameness	wildness
tangibility	intangibility
taper_file	blunt_file
tardiness	punctuality
tastefulness	tastelessness
tastelessness	tastefulness
technical	nontechnical
technophile	technophobe
technophobe	technophile
temperance	intemperance
tender	tough
tense	lax	relax	relaxed
terminal	intermediate
territorial	nonterritorial	extraterritorial
territorial_waters	international_waters	high_sea
terseness	verboseness
testate	intestate
text_edition	trade_edition
theatrical	untheatrical
theism	atheism
there	here
thereness	hereness
thermal	nonthermal
thermal_reactor	fast_reactor
thermoplastic	thermosetting
thick	thin
thickness	thinness
thin_person	fat_person
thinness	thickness
thoughtfulness	unthoughtfulness	thoughtlessness
thoughtlessness	thoughtfulness
tide	ebb
tidiness	untidiness
tidy	untidy
tie	untie
tight_money	easy_money
tightening	loosening
tightness	looseness
time_off	work_time
timeliness	untimeliness
timid	brave	bold
timidity	boldness
tire	refresh
toadstool	mushroom
tolerance	intolerance
tonality	atonality
tonic	atonic
tonicity	atonicity
top	side	bottom
tough	tender
tractability	intractability
trade_edition	text_edition
tragedy	comedy
tramontane	cismontane
transitive	intransitive
transitivity	intransitivity
transparency	opacity
trapezium	parallelogram
travel	stay_in_place
tribalisation	detribalisation
tribalization	detribalization
tributary	distributary
true	false
trust	mistrust	distrust
trustiness	untrustiness
trustworthiness	untrustworthiness
truth	falsehood	falsity
truthfulness	untruthfulness
tubeless	tubed
tune	untune
twine	untwine
twist	untwist
two-piece	one-piece	three-piece
type	antitype
typicality	atypicality
ugliness	beauty
ultimate	proximate
unabridged	abridged
unacceptability	acceptability
unadaptability	adaptability
unaffectedness	affectedness
unalterability	alterability
unambiguity	ambiguity
unappetizingness	appetizingness
unapproachability	approachability
unattractiveness	attractiveness
unavailability	availability
unbalance	balance
unbecomingness	becomingness
unbelief	belief
unbreakableness	breakableness
unceremoniousness	ceremoniousness
uncertainty	certainty
uncheerfulness	cheerfulness
uncle	aunt
uncleanliness	cleanliness
unclearness	clearness
uncommonness	commonness
uncommunicativeness	communicativeness
unconcern	concern
uncongeniality	congeniality
unconnectedness	connectedness
unconscientiousness	conscientiousness
unconscious	conscious
unconsciousness	consciousness
unconventionality	conventionality
uncreativeness	creativeness
undependability	dependability
undependableness	dependableness
underachievement	overachievement
undercharge	overcharge
underestimate	overestimate
undergarment	overgarment
understatement	overstatement
undesirability	desirability
undesirable	desirable
undress	dress
unearned_run	earned_run
unemotional_person	emotional_person
unemotionality	emotionality
unemployed	employed
unemployment	employment
unenlightenment	enlightenment
unequivocalness	equivocalness
unevenness	evenness
unexchangeability	exchangeability
unexpectedness	expectedness
unfairness	fairness
unfaithfulness	faithfulness
unfamiliarity	familiarity
unfavorableness	favorableness
unfitness	fitness
unfortunate	fortunate
unfriendliness	friendliness
ungodliness	godliness
ungraciousness	graciousness
unguiculate	ungulate
ungulate	unguiculate
unhappiness	happiness
unhealthfulness	healthfulness
unholiness	holiness
uniform	multiform
uniformity	nonuniformity
unimportance	importance
uninitiate	initiate
uninsurability	insurability
unintelligibility	intelligibility
uninterestingness	interestingness
union	separation	disunion	nonunion
univalve	bivalve
universal	particular
universal_proposition	particular_proposition
unkindness	kindness
unknown	known
unlawfulness	lawfulness
unleaded_gasoline	leaded_gasoline
unlikelihood	likelihood
unlikeliness	likeliness
unlikeness	likeness
unlisted_security	listed_security
unloading	loading
unmalleability	malleability
unmindfulness	mindfulness
unnaturalness	naturalness
unneighborliness	neighborliness
unobtrusiveness	obtrusiveness
unoriginality	originality
unorthodoxy	orthodoxy
unpalatability	palatability
unperceptiveness	perceptiveness
unpermissiveness	permissiveness
unpersuasiveness	persuasiveness
unpleasantness	pleasantness
unpleasingness	pleasingness
unpointedness	pointedness
unpopularity	popularity
unpredictability	predictability
unpretentiousness	pretentiousness
unproductiveness	productiveness
unprofitability	profitability
unprofitableness	profitableness
unpropitiousness	propitiousness
unreality	reality
unrelatedness	relatedness
unreliability	reliability
unreliableness	reliableness
unrespectability	respectability
unresponsiveness	responsiveness
unrestraint	restraint
unrighteousness	righteousness
unsanitariness	sanitariness
unsatisfactoriness	satisfactoriness
unscrupulousness	scrupulousness
unseasonableness	seasonableness
unsecured_bond	secured_bond
unseemliness	seemliness
unselfconsciousness	self-consciousness
unselfishness	selfishness
unskillfulness	skillfulness
unsociability	sociability
unsolvability	solvability
unsoundness	soundness
unstableness	stableness
unsteadiness	steadiness
unstratified_language	stratified_language
unsuitability	suitability
unsuitableness	suitableness
unsusceptibility	susceptibility
unthoughtfulness	thoughtfulness
untidiness	tidiness
untimeliness	timeliness
untrustiness	trustiness
untrustworthiness	trustworthiness
untruthfulness	truthfulness
unusualness	usualness
unvariedness	variedness
unwariness	wariness
unwellness	wellness
unwholesomeness	wholesomeness
unwillingness	willingness
unworthiness	worthiness
upgrade	downgrade
upland	lowland
uppercase	lowercase
upstage	downstage
upstairs	downstairs
uptick	downtick
uptime	downtime
uptown	downtown
urban_area	rural_area
urbanity	rusticity
usefulness	uselessness
uselessness	usefulness
usualness	unusualness
utility	inutility
utopia	dystopia
utopian	dystopian
valgus	varus
valuable	worthless
variability	invariability
variable	invariable
variableness	invariableness
variedness	unvariedness
varietal	generic
varietal_wine	generic_wine
varus	valgus
veil	unveil
venial_sin	mortal_sin
veracity	mendacity
verboseness	terseness
vernal_equinox	autumnal_equinox
verso	recto
vertebrate	invertebrate
vertical	inclined	horizontal
victory	defeat
visibility	invisibility
vocal	instrumental
voice	devoice
volatile	nonvolatile
volatile_storage	non-volatile_storage	nonvolatile_storage
volley	ground_stroke
voltaic_cell	electrolytic_cell
voluntary	involuntary
volunteer	draftee
vomit	keep_down
vowel	consonant
vulnerability	invulnerability
wake	sleep
wakefulness	sleepiness
waking	sleeping
walk	ride
wane	wax
waning	waxing
war	make_peace	peace
wariness	unwariness
waste	conserve
wave_theory	corpuscular_theory
wave_theory_of_light	corpuscular_theory_of_light
wax	wane
waxing	waning
weak_part	good_part
weak_point	strong_point
weakening	strengthening
weakness	strength
wealth	poverty
wearable	unwearable
weave	unweave
weed	cultivated_plant
welcome	unwelcome	say_farewell
well	ill	badly
well-being	ill-being
wellness	unwellness	illness
west	east
westerly	easterly
western	eastern
wet	dry
wet-bulb_thermometer	dry-bulb_thermometer
wet_fly	dry_fly
wetness	dryness
whisper	shout
white	black
whole	half	fractional
whole_milk	skim_milk
wholesale	retail
wholesomeness	unwholesomeness
wideness	narrowness
widening	narrowing
wife	husband
wild	tame
wildness	tameness
willing	unwilling
willingness	unwillingness
win	lose
wind	unwind
windward	leeward
winner	loser
winnings	losings
winter_solstice	summer_solstice
wire	unwire
wireless	wired
wisdom	folly
wise	foolish
wish	begrudge
withholder	granter
woman	man
won	lost
work	idle
work_time	time_off
workday	rest_day
worker	nonworker
worldliness	otherworldliness
worry	reassure
worse	better
worsening	bettering
worst	best
worth	worthlessness
worthiness	unworthiness
worthlessness	worth
worthy	unworthy
wrap	unwrap
wrong	right
wrongfulness	rightfulness
wrongness	rightness
yang	yin
yea	nay
yes	no
yield	stand
yin	yang
yoke	unyoke
young	old	aged
youngness	oldness
zenith	nadir
zygodactyl_foot	heterodactyl_foot
abduct	adduct
abolish	establish
absent	present
absolve	blame
absorb	emit
abstain	consume
accelerate	decelerate
accept	refuse	reject
acidify	alkalize
acquit	convict
activate	inactivate
admire	look_down_on
admit	reject	deny	exclude
aestivate	hibernate
affirm	negate
aggrade	degrade
agitate	calm
agree	disagree
align	skew
alkalize	acidify
allow	disallow	deny
analyze	synthesize
anesthetize	bring_to
animate	inanimate
appear	disappear
applaud	boo
appreciate	depreciate
approbate	reprobate
appropriate	inappropriate
approve	disapprove
arise	lie_down	sit_down
arrange	disarrange
arrive	leave
articulate	inarticulate
ascend	descend
assemble	disassemble
assimilate	dissimilate
attach	detach
attend	miss
attend_to	neglect
attract	repel
avoid	confront
avow	disavow
awake	asleep
awaken	cause_to_sleep
bare	covered
be_active	rest
be_born	die
be_full	starve
be_well	suffer
beautify	uglify
begrudge	wish
behave	misbehave
believe	disbelieve
bequeath	disinherit
blacken	whiten
bless	curse
bloody	bloodless
blow_up	reduce
borrow	lend
bottlefeed	breastfeed
bottom_out	top_out
break_even	lose	profit
breastfeed	bottlefeed
brighten	darken
bring	take_away
bring_to	anesthetize
busy	idle
calcify	decalcify
carry_to_term	miscarry
cast_off	cast_on
cast_on	cast_off
cause_to_sleep	awaken
centralise	decentralise
centralize	decentralize
certify	decertify
check_in	check_out
check_out	check_in
clarify	obfuscate
classify	declassify
clear_up	overcast
clock_in	clock_out
clock_out	clock_in
close_up	open_up
colonise	decolonise
colonize	decolonize
come_in	go_out
communicate	excommunicate
compassionate	uncompassionate
complain	cheer
complete	incomplete
complicate	simplify
confine	free
conform	deviate
conform_to	violate
confront	avoid
connect	disconnect
consecrate	desecrate
consume	abstain
contaminate	decontaminate
continue	discontinue
contract_in	contract_out
contract_out	contract_in
contraindicate	indicate
converge	diverge
correct	falsify	incorrect
corrupt	incorrupt
criminalise	decriminalise
criminalize	decriminalize
criticize	praise
curdle	homogenise	homogenize
darken	lighten	brighten
de-energise	energise
de-energize	energize
de-escalate	escalate
de-iodinate	iodinate
de-ionate	ionate
deaden	enliven
decalcify	calcify
deceive	undeceive
decelerate	accelerate
decentralize	centralise	centralize
decertify	certify
declassify	classify
decode	encode
decolonise	colonise
decolonize	colonize
decompress	compress
deconcentrate	concentrate
decontaminate	contaminate
decriminalise	criminalise
decriminalize	criminalize
dedifferentiate	differentiate
defend	prosecute	attack
deflate	inflate
defuse	fuse
defy	lend_oneself
deglycerolize	glycerolize
degrade	aggrade
dehumanize	humanize
dehumidify	humidify
dehydrate	hydrate
dehydrogenate	hydrogenate
demagnetise	magnetise
demagnetize	magnetize
dematerialise	materialise
dematerialize	materialize
demilitarise	militarise
demilitarize	militarize
demobilise	mobilise
demobilize	mobilize
demote	promote
demulsify	emulsify
demystify	mystify
demythologize	mythologize
denationalise	nationalise
denationalize	nationalize
denaturalize	naturalize
denazify	nazify
denitrify	nitrify
deny	allow	admit
deodorize	odorize
deodourise	odourise
deoxidise	oxidise
deoxidize	oxidize
depart	stay
depersonalise	personalise
depersonalize	personalize
depreciate	appreciate
depress	elate
depressurise	pressurise
depressurize	pressurize
deprive	enrich
deregulate	regulate
derequisition	requisition
derestrict	restrict
desalinate	salinate
descend	ascend
desecrate	consecrate
desegregate	segregate
desensitise	sensitise
desensitize	sensitize
destabilise	stabilise	stabilize
destabilize	stabilize
destalinize	stalinize
desynchronise	synchronise
desynchronize	synchronize
detach	attach
deteriorate	recuperate
dethrone	enthrone
detransitivize	transitivize
devitalize	vitalize
devoice	voice
differ	equal
differentiate	integrate	dedifferentiate
direct	alternating	indirect	inverse	retrograde
dirty	clean
disable	enable
disagree	agree
disallow	allow
disappear	appear
disapprove	approve
disarm	arm
disarrange	arrange
disassemble	assemble
disavow	avow
disbelieve	believe
disclaim	claim
discolor	color
discontinue	continue
discourage	encourage
discriminate	indiscriminate
disembark	embark
disenchant	enchant
disenfranchise	enfranchise
disengage	engage
disentangle	entangle
dishearten	hearten
disincarnate	incarnate
disinfect	infect
disinherit	bequeath
disintegrate	integrate
disjoin	join
dislodge	lodge
disobey	obey
disoblige	oblige
disorganise	organise
disorganize	organize
disorient	orient
disparage	flatter
displease	please
dispose	indispose
disprove	prove
disqualify	qualify
dissatisfy	satisfy
dissimilate	assimilate
dissociate	associate
dissuade	persuade
disunify	unify
diverge	converge
diversify	specialize	specialise
divest	invest
download	upload
dress_down	dress_up
dress_up	dress_down
drop_out	enter
dull	sharp	bright	lively	sharpen
eat_in	eat_out
eat_out	eat_in
elate	depress
embark	disembark
emigrate	immigrate
emit	absorb
emulsify	demulsify
enable	disable
enchant	disenchant
encode	decode
encourage	discourage
energise	de-energise
energize	de-energize
enforce	exempt
enfranchise	disenfranchise
engage	disengage
enjoy	suffer
enlist	discharge
enliven	deaden
enrich	impoverish	deprive
entangle	disentangle
enter	drop_out	exit
enthrone	dethrone
erase	record
erect	unerect
escalate	de-escalate
establish	abolish
estivate	hibernate
exact	inexact
exclude	admit	include
excommunicate	communicate
exempt	nonexempt	enforce
exhale	inhale
expand	contract
explode	implode
extinguish	ignite
fail	succeed	manage	pass
fall_asleep	wake_up
fall_back	gain
fall_short_of	satisfy
falsify	correct
fasten	unfasten
file_in	file_out
file_out	file_in
flatten	sharpen
flatter	disparage
follow	precede
forbid	permit
forget	remember	mind
frequent	infrequent
generalize	specify
get_off	get_on
get_on	get_off
get_up	go_to_bed
get_well	get_worse
get_worse	get_well
gladden	sadden
glycerolize	deglycerolize
go_off	go_on
go_on	go_off
go_out	come_in
go_to_bed	get_up
handwash	machine_wash
harden	soften
hearten	dishearten
hibernate	aestivate	estivate
homogenise	curdle
homogenize	curdle
hop_on	hop_out
hop_out	hop_on
humanize	dehumanize
humble	proud
humidify	dehumidify
hydrogenate	dehydrogenate
ignite	extinguish
ignore	notice	know
immigrate	emigrate
implode	explode
impoverish	enrich
inactivate	activate
incarnate	disincarnate
include	exclude
indicate	contraindicate
indispose	dispose
infect	disinfect
inflate	deflate
inhale	exhale
inspan	outspan
integrate	disintegrate	differentiate
invalidate	validate
invest	divest
iodinate	de-iodinate
ionate	de-ionate
irritate	soothe
keep_down	vomit
keep_quiet	talk
keep_track	lose_track
leave_office	take_office
legalise	outlaw
legalize	outlaw
legitimate	illegitimate
lend	borrow
lend_oneself	defy
lengthen	shorten
let_go_of	hold
let_out	take_in
lie_down	arise
lighten	darken	weigh_down
linger	rush
literalize	spiritualize
live	recorded	dead
live_in	live_out
live_out	live_in
log_in	log_out
log_out	log_in
long	short
look_down_on	admire
loose	compact	tight
loosen	stiffen
lose	profit	break_even	win	find	keep
lose_track	keep_track
louden	quieten
machine_wash	handwash
magnetise	demagnetise
magnetize	demagnetize
make_peace	war
malign	benign
manage	fail
mark_down	mark_up
mark_up	mark_down
materialise	dematerialise
materialize	dematerialize
mature	immature
maximise	minimise
maximize	minimize
mediate	immediate
militarise	demilitarise
militarize	demilitarize
minimise	maximise
minimize	maximize
misbehave	behave
miscarry	carry_to_term
mobilise	demobilise
mobilize	demobilize
move_in	move_out
move_out	move_in
multiply	singly	divide
mystify	demystify
mythologize	demythologize
nationalise	denationalise
nationalize	denationalize
naturalize	denaturalize
nazify	denazify
near	far
necessitate	obviate
negate	affirm
nitrify	denitrify
numerate	innumerate
obey	disobey
obfuscate	clarify
obligate	facultative
oblige	disoblige
obstruct	free
obviate	necessitate
occidentalise	orientalise
occidentalize	orientalize
odorize	deodorize
odourise	deodourise
off	on
open_up	close_up
organise	disorganise
organize	disorganize
orientalise	occidentalise
orientalize	occidentalize
outbid	underbid
outspan	inspan
overact	underact
overdress	underdress
overexpose	underexpose
overpay	underpay
overspend	underspend
overstate	understate
overstock	understock
overvalue	undervalue
oxidise	deoxidise
oxidize	deoxidize
patronise	boycott
patronize	boycott
pay_cash	charge
pay_up	default
personalise	depersonalise
personalize	depersonalize
persuade	dissuade
phase_in	phase_out
phase_out	phase_in
play_down	play_up
play_up	play_down
please	displease
plug_in	unplug
pop_in	pop_out
pop_out	pop_in
postdate	predate
precede	succeed	follow
predate	postdate
pressurise	depressurise
pressurize	depressurize
prevent	let
profane	sacred
promote	demote
prosecute	defend
prove	disprove
pull_in	pull_out
pull_out	pull_in
punch_in	punch_out
punch_out	punch_in
qualify	disqualify
quieten	louden
reassure	worry
recede	advance
recuperate	deteriorate
reduce	blow_up	gain
refresh	tire
regenerate	unregenerate
regulate	deregulate
rehabilitate	purge
rejuvenate	age
relax	tense
remember	forget
repel	attract
resist	surrender
restrict	derestrict
reticulate	nonreticulate
retrograde	direct	anterograde
roll_up	unfurl
roughen	smooth
sadden	gladden
salinate	desalinate
satiate	insatiate
satisfy	dissatisfy	fall_short_of
say_farewell	welcome
scale_down	scale_up
scale_up	scale_down
secure	insecure
sedate	stimulate
sensitise	desensitise
sensitize	desensitize
sharpen	soften	flatten	dull
sheathe	unsheathe
shorten	lengthen
shut	open
simplify	complicate
sit	stand	lie
sit_down	arise
skew	align
slip_off	slip_on
slip_on	slip_off
slow	fast
sober	intoxicated
soften	harden	sharpen
soothe	irritate
specialise	diversify
specialize	diversify
specify	generalize
spiritualize	literalize
stabilise	destabilise
stabilize	destabilize	destabilise
stale	fresh
stalinize	destalinize
stand_still	move
starve	be_full	feed
stay_in_place	travel
stiffen	loosen
stimulate	stifle	sedate
straighten	bend
strengthen	weaken
subtract	add
succeed	fail	precede
succumb	survive
suffer	be_well	enjoy
summerize	winterize
survive	succumb
sweeten	sour
switch_off	switch_on
switch_on	switch_off
synchronise	desynchronise
synchronize	desynchronize
synthesize	analyze
take_away	bring	add
take_in	let_out
take_office	leave_office
talk_into	talk_out_of
talk_out_of	talk_into
tame	wild
thicken	thin
thin	thicken	full	thick	fat
top_out	bottom_out
transitivize	detransitivize
turn_in	turn_out
turn_out	turn_in
uglify	beautify
unbar	bar
unbelt	belt
unbend	bend
unbind	bind
unblock	block
unbolt	bolt
unbox	box
unbraid	braid
unbridle	bridle
unbuckle	buckle
unburden	burden
unbutton	button
unchain	chain
unclasp	clasp
unclip	clip
unclog	clog
unclutter	clutter
uncoil	coil
uncork	cork
uncouple	couple
uncover	cover
uncrate	crate
uncross	cross
undeceive	deceive
underact	overact
underbid	overbid	outbid
underdress	overdress
underexpose	overexpose
underpay	overpay
undershoot	overshoot
underspend	overspend
understate	overstate
understock	overstock
undervalue	overvalue
undock	dock
unfasten	fasten
unfit	fit
unfold	fold
unfreeze	freeze
unfurl	roll_up
unharness	harness
unhitch	hitch
unhook	hook
unify	disunify
unite	divide
unknot	knot
unlash	lash
unlock	lock
unmake	make
unmask	mask
unmuzzle	muzzle
unpack	pack
unpin	pin
unplug	plug_in
unravel	ravel
unsaddle	saddle
unscramble	scramble
unscrew	screw
unseal	seal
unsheathe	sheathe
unsnarl	snarl
unspell	spell
unstaple	staple
unstrain	strain
unstrap	strap
unstring	string
unstuff	stuff
untie	tie
untune	tune
untwine	twine
untwist	twist
unveil	veil
unweave	weave
unwind	wind
unwire	wire
unwrap	wrap
unyoke	yoke
unzip	zip_up
up	down
upload	download
validate	invalidate
veer	back
violate	conform_to
vitalize	devitalize
wake_up	fall_asleep
warm	cool
weaken	strengthen
weigh_down	lighten
whiten	blacken
widen	narrow
winterize	summerize
withdraw	deposit
worsen	better
zip_up	unzip
a_posteriori	a_priori
a_priori	a_posteriori
abactinal	actinal
abaxial	adaxial
abient	adient
able	unable
abnormal	normal
aboral	oral
abranchiate	branchiate
abridged	unabridged
absorbable	adsorbable
abstemious	gluttonous
abundant	scarce
abused	unabused
acarpelous	carpellate
acaudate	caudate
acaulescent	caulescent
accentual	syllabic	quantitative
acceptable	unacceptable
acceptive	rejective
accessible	inaccessible
accommodating	unaccommodating
accompanied	unaccompanied
accordant	discordant
accurate	inaccurate
accusatorial	inquisitorial
accustomed	unaccustomed
achlamydeous	chlamydeous
achondritic	chondritic
achromatic	chromatic
achromatinic	chromatinic
acid-loving	alkaline-loving
acidic	amphoteric	alkaline
acknowledged	unacknowledged
acquisitive	unacquisitive
acrocarpous	pleurocarpous
acropetal	basipetal
acroscopic	basiscopic
actable	unactable
actinal	abactinal
actinomorphic	zygomorphic
actual	potential
acyclic	cyclic
adaptable	unadaptable
adaptive	maladaptive
adaxial	abaxial
addicted	unaddicted
addictive	nonaddictive
addressed	unaddressed
adducent	abducent
adequate	inadequate
adiabatic	diabatic
adient	abient
adjusted	unadjusted	maladjusted
admissible	inadmissible
adnate	connate
adoptable	unadoptable
adopted	native
adoptive	biological
adorned	unadorned
adroit	maladroit
adscript	superscript	subscript
adsorbable	absorbable
adulterating	purifying
advantageous	disadvantageous
adventurous	unadventurous
advisable	inadvisable
aerobic	anaerobic
afebrile	febrile
affected	unaffected
affixed	unaffixed
afloat	aground
afraid	unafraid
aft	fore
aggressive	unaggressive
agitated	unagitated
agreeable	disagreeable
aground	afloat
ahead	back
ahistorical	historical
air-to-air	surface-to-air	air-to-surface
air-to-surface	surface-to-air	air-to-air
airworthy	unairworthy
alarming	unalarming
algorithmic	heuristic
alienable	inalienable
aligned	nonaligned
alike	unalike
alive	dead
alkaline	amphoteric	acidic
alkaline-loving	acid-loving
all	no	some
allochthonous	autochthonous
allogeneic	xenogeneic
allopathic	homeopathic
allopatric	sympatric
alphabetic	analphabetic
alterable	unalterable
altered	unaltered
alternating	direct
altricial	precocial
altruistic	egoistic
ambidextrous	right-handed	left-handed
ambiguous	unambiguous
ambitious	unambitious
ambiversive	introversive	extroversive
amended	unamended
ametabolic	metabolic
ametropic	emmetropic
amicable	hostile
amphibious	aquatic	terrestrial
amphitropous	anatropous
amphoteric	alkaline	acidic
ample	meager
anabatic	katabatic
anabolic	catabolic
anaclinal	cataclinal
anadromous	diadromous	catadromous
anaerobic	aerobic
anal	oral
analogous	heterologous	homologous
analytic	synthetic
analyzed	unanalyzed
anaphrodisiac	aphrodisiac
anastigmatic	astigmatic
anatropous	amphitropous
androgynous	female	male
anemophilous	entomophilous
anestrous	estrous
angry	unangry
angular	rounded
anhydrous	hydrous
animated	unanimated
anisotropic	isotropic
anodic	cathodic
anonymous	onymous
antagonistic	synergistic	conciliatory
antemeridian	postmeridian
antemortem	postmortem
anterograde	retrograde
anticlimactic	climactic
anticlinal	synclinal
antimagnetic	magnetic
antonymous	synonymous
antrorse	retrorse
aperiodic	periodic
apetalous	petalous
aplacental	placental
apocarpous	syncarpous
apocrine	eccrine
apologetic	unapologetic
appealable	unappealable
appealing	unappealing
appendaged	unappendaged
appetizing	unappetizing
applied	theoretical
appointive	elective
approachable	unapproachable
apropos	malapropos
apteral	peripteral
aqueous	igneous
arbitrable	nonarbitrable
arbitrary	nonarbitrary
arboreal	nonarboreal
arenaceous	argillaceous
argillaceous	arenaceous
argumentative	unargumentative
armed	armless	unarmed
armless	armed
armored	unarmored
arranged	disarranged
artesian	subartesian
artful	artless
articulated	unarticulated
artificial	natural
artless	artful
asexual	sexual
ashamed	unashamed
asleep	awake
assertive	unassertive
assigned	unassigned
assisted	unassisted
associative	nonassociative
astigmatic	anastigmatic
astomatous	stomatous
asymmetrical	symmetrical
asynchronous	synchronous
asyndetic	syndetic
atomistic	holistic
atonal	tonal
atonic	tonic
atrophied	hypertrophied
attachable	detachable
attached	unattached	detached
attentive	inattentive
attractive	unattractive	repulsive
attributable	unattributable
attributive	predicative
atypical	typical
auspicious	inauspicious
authorized	unauthorized
autochthonous	allochthonous
autoecious	heteroecious
autogamous	exogamous	endogamous
autogenous	heterogenous
autologous	heterologous	homologous
autotrophic	heterotrophic
autumnal	vernal	wintry	summery
available	unavailable
avascular	vascular
avenged	unavenged
avirulent	virulent
awakened	unawakened
aware	unaware
away	home
awed	unawed
awkward	graceful
awned	awnless
awnless	awned
azonal	zonal
backed	backless
backless	backed
backward	forward
balanced	unbalanced
balconied	unbalconied
banded	unbanded
baptized	unbaptized
barreled	unbarreled
basipetal	acropetal
basiscopic	acroscopic
beaked	beakless
beakless	beaked
beautiful	ugly
bedded	bedless
bedless	bedded
bellied	bellyless
bellyless	bellied
belted	unbelted
beneficed	unbeneficed
beneficent	maleficent
benign	malign	malignant
beseeching	imperative
bettering	worsening
bibbed	bibless
bibless	bibbed
bicameral	unicameral
bidirectional	unidirectional
big	little	small
bimodal	unimodal
binaural	monaural
binucleate	trinucleate	mononuclear
biological	adoptive
bipedal	quadrupedal
bipolar	unipolar
bivalent	multivalent	univalent
black-and-white	color
blemished	unblemished
blended	unblended
blessed	cursed
bloodless	bloody
blue-collar	white-collar
bodied	unbodied
boneless	bony
bony	boneless
bordered	unbordered
bottle-fed	breast-fed
bottom-up	top-down
bottomed	bottomless
bottomless	bottomed
bowed	plucked
bracteate	ebracteate
brainwashed	unbrainwashed
branchiate	abranchiate
branchless	branchy
branchy	branchless
branded	unbranded
breast-fed	bottle-fed
breasted	breastless
breastless	breasted
breathless	breathing
bridgeable	unbridgeable
bright	dull
broad-minded	narrow-minded
broken	unbroken
brotherly	sisterly
burdened	unburdened
buried	unburied
buttoned	unbuttoned
cacophonous	euphonious
caducous	persistent
calced	discalced
calcicolous	calcifugous
calcifugous	calcicolous
calculable	incalculable
camphorated	uncamphorated
campylotropous	orthotropous
capable	incapable
capitalistic	socialistic
cared-for	uncared-for
careful	careless
careless	careful
carnivorous	omnivorous	insectivorous	herbivorous
carpellate	acarpelous
carpeted	uncarpeted
carved	uncarved
carvel-built	clinker-built
castrated	uncastrated
catabolic	anabolic
cataclinal	anaclinal
catadromous	anadromous	diadromous
categorematic	syncategorematic
cathodic	anodic
cationic	anionic
caudal	cephalic
caulescent	acaulescent
cauline	radical
caulked	uncaulked
causative	noncausative
ceilinged	floored
cellular	noncellular
cenobitic	eremitic
cenogenetic	palingenetic
censored	uncensored
centralized	decentralized
centralizing	decentralizing
centrifugal	centripetal
centripetal	centrifugal
cephalic	caudal
cerebral	emotional
certain	uncertain
certified	uncertified
changeable	unchangeable
changed	unchanged
charged	uncharged
charitable	uncharitable
chartered	unchartered
chaste	unchaste
cheap	expensive
cheerful	depressing
chlamydeous	achlamydeous
cholinergic	anticholinergic
chondritic	achondritic
chromatic	diatonic	achromatic
chromatinic	achromatinic
chronic	acute
cismontane	tramontane
civil	uncivil	sidereal
civilized	noncivilized
cleared	uncleared
clearheaded	confused
clement	inclement
climactic	anticlimactic
clinker-built	carvel-built
clockwise	counterclockwise
closed	open
clothed	unclothed
cloudy	clear
coarse	fine
coastal	inland
coated	uncoated
coherent	incoherent
coiled	uncoiled
cold-blooded	warm-blooded
coldhearted	warmhearted
collapsible	noncollapsible
collected	uncollected
colorful	colorless
colorless	colorful
colourful	colourless
colourless	colourful
columned	noncolumned
combed	uncombed
combinative	noncombinative
combined	uncombined
comfortable	uncomfortable
commensurate	incommensurate
commissioned	noncommissioned
committed	uncommitted
commodious	incommodious
communicative	uncommunicative
commutable	incommutable
comparable	incomparable
compartmented	uncompartmented
compatible	incompatible
competent	incompetent
competitive	noncompetitive
complaining	uncomplaining
compliant	defiant
complimentary	uncomplimentary
composed	discomposed
comprehensible	incomprehensible
compressible	incompressible
compromising	uncompromising
concave	convex
concealed	unconcealed
concentrated	distributed
concentric	eccentric
concerned	unconcerned
conciliatory	antagonistic
concise	prolix
conclusive	inconclusive
conditional	unconditional
conditioned	unconditioned
conductive	nonconductive
confident	diffident
confined	invasive	unconfined
confirmed	unconfirmed
confused	clearheaded
congenial	uncongenial
congruent	incongruent
congruous	incongruous
conjunct	disjunct
connate	adnate
connected	unconnected
connotative	denotative
conquerable	unconquerable
conscientious	unconscientious
conscious	unconscious
consecrated	desecrated
considerable	inconsiderable
considerate	inconsiderate
consistent	inconsistent
consolable	inconsolable
consonantal	vocalic
conspicuous	inconspicuous
constipated	unconstipated
constricted	unconstricted
constructive	destructive
consummated	unconsummated
contaminated	uncontaminated
contemptible	estimable
contented	discontented
contestable	incontestable
contested	uncontested
continental	intercontinental
continual	sporadic
continued	discontinued
continuous	discontinuous
contracted	expanded
contralateral	ipsilateral
contrasty	flat
controlled	uncontrolled
controversial	uncontroversial
convenient	inconvenient
conventional	nuclear	unconventional
convergent	divergent
convex	concave
convinced	unconvinced
convincing	unconvincing
cooked	raw
coordinating	subordinating
corporeal	incorporeal
corrected	uncorrected
corrigible	incorrigible
costive	laxative
counterclockwise	clockwise
courteous	discourteous
cousinly	uncousinly
covered	bare
cowardly	brave
crannied	uncrannied
creative	uncreative
credible	incredible
credulous	incredulous
critical	uncritical	noncritical
crooked	straight
cross-eyed	walleyed
crossbred	purebred
crossed	uncrossed
crosswise	lengthwise
crowded	uncrowded
crowned	uncrowned
crucial	noncrucial
crystalline	noncrystalline
crystallized	uncrystallized
cubic	linear	planar
cultivated	uncultivated
curable	incurable
curious	incurious
curly	straight
cursed	blessed
cursorial	fossorial
curtained	curtainless
curtainless	curtained
curved	straight
cyclic	noncyclic	acyclic
damaged	undamaged
dangerous	safe
datable	undatable
de-iodinating	iodinating
de_facto	de_jure
de_jure	de_facto
debilitating	invigorating
decent	indecent
decentralized	centralized
decentralizing	centralizing
deciduous	evergreen
deciphered	undeciphered
decisive	indecisive
declaratory	interrogatory
declared	undeclared
decorous	indecorous
decreased	increased
decreasing	increasing
dedicated	undedicated
deductive	inductive
defeasible	indefeasible
defiant	compliant
defined	undefined
definite	indefinite
deflationary	inflationary
dehiscent	indehiscent
dejected	elated
delicate	rugged
delineated	undelineated
demanding	undemanding
democratic	undemocratic
deniable	undeniable
denotative	connotative
dependable	undependable
depressing	cheerful
derivational	inflectional
derived	underived
descending	ascending
descriptive	undescriptive	prescriptive
desecrated	consecrated
desensitizing	sensitizing
designed	undesigned
desirable	undesirable
desirous	undesirous
destroyed	preserved
destructible	indestructible
destructive	constructive
detachable	attachable
detached	attached
detected	undetected
determinable	indeterminable
determinate	indeterminate
determined	undetermined
developed	undeveloped
dextral	sinistral
diabatic	adiabatic
diachronic	synchronic
diadromous	anadromous	catadromous
diatonic	chromatic
diclinous	monoclinous
dicotyledonous	monocotyledonous
different	same
differentiated	undifferentiated
difficult	easy
diffident	confident
digestible	indigestible
digital	analogue
dignified	undignified
diligent	negligent
diluted	undiluted
dimmed	undimmed
dioecious	monoecious
diplomatic	undiplomatic
directional	omnidirectional
disabling	enabling
disadvantageous	advantageous
disagreeable	agreeable
disarranged	arranged
discalced	calced
discernible	indiscernible
discerning	undiscerning
discomposed	composed
discontented	contented
discontinued	continued
discontinuous	continuous
discordant	accordant
discouraging	encouraging
discourteous	courteous
discreet	indiscreet
discriminating	undiscriminating
disenchanted	enchanted
disenfranchised	enfranchised
dishonest	honest
dishonorable	honorable
disinclined	inclined
disingenuous	ingenuous
disintegrative	integrative
disjunct	conjunct
disjunctive	conjunctive
disliked	liked
disloyal	loyal
disobedient	obedient
disordered	ordered
disorderly	orderly
disorganized	organized
disorienting	orienting
dispensable	indispensable
displeased	pleased
displeasing	pleasing
disproportionate	proportionate
disreputable	reputable
disrespectful	respectful
dissimilar	similar
dissuasive	persuasive
distal	mesial	proximal
distant	close
distinct	indistinct
distinguishable	indistinguishable
distributed	concentrated
distributive	collective
distrustful	trustful
diurnal	nocturnal
divergent	convergent
diversified	undiversified
divided	united
divisible	indivisible
docile	stubborn
documented	undocumented
domineering	submissive
dormant	active
dorsal	ventral
double-barreled	single-barreled
double-breasted	single-breasted
downmarket	upmarket
downstairs	upstairs
downstream	upstream
downward	upward
downwind	upwind
drained	undrained
dramatic	lyric	undramatic
dysgenic	eugenic
dysphemistic	euphemistic
dysphoric	euphoric
dystopian	utopian
eared	earless
earless	eared
early	late	middle
earned	unearned
earthly	heavenly
eastern	western
easy	uneasy	difficult
ebracteate	bracteate
eccrine	apocrine
ecdemic	endemic	epidemic
echoic	nonechoic
ectomorphic	endomorphic	mesomorphic
edifying	unedifying
educated	uneducated
effective	ineffective
effervescent	noneffervescent
efficacious	inefficacious
efficient	inefficient
effortful	effortless
effortless	effortful
egoistic	altruistic
elated	dejected
elegant	inelegant
eligible	ineligible
emmetropic	ametropic
emotional	cerebral	unemotional
empirical	theoretical
employed	unemployed
enabling	disabling
enchanted	disenchanted
enclosed	unenclosed
encouraging	discouraging
encumbered	unencumbered
end-stopped	run-on
endergonic	exergonic
endocentric	exocentric
endoergic	exoergic
endogamous	autogamous	exogamous
endogenic	exogenic
endogenous	exogenous
endomorphic	ectomorphic	mesomorphic
endothermic	exothermic
endowed	unendowed
energetic	lethargic
enforceable	unenforceable
enforced	unenforced
enfranchised	disenfranchised
enlightening	unenlightening
enlivened	unenlivened
enterprising	unenterprising
enthusiastic	unenthusiastic
entomophilous	anemophilous
entozoic	epizoic
epizoic	entozoic
equipped	unequipped
equitable	inequitable
equivocal	unequivocal
eradicable	ineradicable
eremitic	cenobitic
esoteric	exoteric
established	unestablished
estimable	contemptible
estrous	anestrous
ethical	unethical
eucaryotic	procaryotic
eugenic	dysgenic
eukaryotic	prokaryotic
euphemistic	dysphemistic
euphonious	cacophonous
euphoric	dysphoric
eusporangiate	leptosporangiate
eventful	uneventful
evitable	inevitable
exaugural	inaugural
exchangeable	unexchangeable
excitable	unexcitable
excited	unexcited
exciting	unexciting
exculpatory	inculpatory
excusable	inexcusable
exergonic	endergonic
exhausted	unexhausted
exhaustible	inexhaustible
existent	nonexistent
exocentric	endocentric
exoergic	endoergic
exogamous	autogamous	endogamous
exogenic	endogenic
exogenous	endogenous
exoteric	esoteric
exothermic	endothermic
expanded	contracted
expansive	unexpansive
expected	unexpected
expendable	unexpendable
expensive	cheap
experienced	inexperienced
expired	unexpired
explicable	inexplicable
explicit	implicit
exploited	unexploited
exploratory	nonexploratory
exportable	unexportable
expressible	inexpressible
extant	extinct
extended	unextended
extensile	nonextensile
extensive	intensive
extinct	extant	active
extinguishable	inextinguishable
extracellular	intracellular
extramural	intramural
extraordinary	ordinary
extrasensory	sensory
extraterritorial	territorial
extricable	inextricable
extrinsic	intrinsic
extrospective	introspective
extroversive	introversive	ambiversive
extrusive	intrusive
eyed	eyeless
eyeless	eyed
faced	faceless
faceless	faced
faceted	unfaceted
factory-made	homemade
facultative	obligate
fallible	infallible
falling	rising
false	true
farsighted	nearsighted
fashionable	unfashionable
fastened	unfastened
fastidious	unfastidious
fatal	nonfatal
fathomable	unfathomable
favorable	unfavorable
feathered	unfeathered
febrile	afebrile
felicitous	infelicitous
ferned	fernless
fernless	ferned
fertile	sterile
fewer	more
fewest	most
fictional	nonfictional
figurative	literal
filial	parental
filled	unfilled
financial	nonfinancial
fingered	fingerless
fingerless	fingered
finished	unfinished
finite	infinite
fissile	nonfissile
fissionable	nonfissionable
fixed	unfixed
flattering	unflattering
fledged	unfledged
flexible	inflexible
floored	ceilinged
flowerless	flowering
focused	unfocused
foolish	wise
footed	footless
footless	footed
forceful	forceless
forceless	forceful
foreign	native	domestic
forgettable	unforgettable
forgiving	unforgiving
formed	unformed
fortunate	unfortunate
fossorial	cursorial
fractional	whole
fragrant	malodorous
framed	unframed
fraternal	identical
fresh	salty	preserved	stale
fretted	unfretted
frivolous	serious
frozen	unfrozen
fruitful	unfruitful
fueled	unfueled
full-term	premature
full-time	half-time	part-time
functional	organic	nonfunctional
funded	unfunded
furnished	unfurnished
furrowed	unfurrowed
gabled	hipped
gaseous	solid	liquid
gathered	ungathered
geared	ungeared
generative	consumptive
generous	stingy	ungenerous
genuine	counterfeit
geocentric	heliocentric
geographic	magnetic
germfree	germy
germy	germfree
glazed	unglazed
glorious	inglorious
gloved	gloveless
gloveless	gloved
gluttonous	abstemious
good-natured	ill-natured
graceful	awkward
gracious	ungracious
grammatical	ungrammatical
grassless	grassy
grassy	grassless
grateful	ungrateful
greater	lesser
gregarious	ungregarious
groomed	ungroomed
guided	unguided
guilty	innocent
gusseted	ungusseted
gutless	gutsy
gutsy	gutless
hairless	hairy
hairy	hairless
half-time	full-time
handed	handless
handled	handleless
handleless	handled
handless	handed
handmade	machine-made
happy	unhappy
hard	soft
hardened	soft
hardhearted	softhearted
harmful	harmless
harmless	harmful
harmonious	inharmonious
hateful	lovable
hatless	hatted
hatted	hatless
headed	headless	unheaded
headless	headed
healthful	unhealthful
healthy	unhealthy
heavenly	earthly
heavy-duty	light-duty
heavy-footed	light-footed
heedful	heedless
heedless	heedful
heliocentric	geocentric
helpful	unhelpful
herbivorous	omnivorous	carnivorous	insectivorous
heterocercal	homocercal
heterodactyl	zygodactyl
heteroecious	autoecious
heterogeneous	homogeneous
heterogenous	autogenous
heterologous	analogous	autologous	homologous
heterotrophic	autotrophic
heterozygous	homozygous
hierarchical	nonhierarchical
high-interest	low-interest
high-resolution	low-resolution
high-sudsing	low-sudsing
high-tech	low-tech
high-tension	low-tension
hipless	hipped
hipped	hipless	gabled
historical	ahistorical
holistic	atomistic
holophytic	holozoic
holozoic	holophytic
homemade	factory-made
homeopathic	allopathic
homocercal	heterocercal
homogeneous	heterogeneous
homologous	analogous	heterologous	autologous
homozygous	heterozygous
honest	dishonest
honorable	dishonorable
hopeless	hopeful
horned	hornless
hornless	horned
hospitable	inhospitable
hot	cold
humane	inhumane
humorless	humorous
humorous	humorless
hungry	thirsty
hurried	unhurried
husbandly	wifely
hydric	mesic	xeric
hydrokinetic	hydrostatic
hydrophilic	hydrophobic
hydrophobic	hydrophilic
hydrostatic	hydrokinetic
hydrous	anhydrous
hypertonic	hypotonic	isotonic
hypertrophied	atrophied
hypotonic	hypertonic	isotonic
identical	fraternal
identifiable	unidentifiable
idiographic	nomothetic
igneous	aqueous
ignoble	noble
ill-advised	well-advised
ill-defined	well-defined
ill-natured	good-natured
illegal	legal
illegible	legible
illicit	licit
illogical	logical
imitative	nonimitative
immanent	transeunt
immaterial	material
immature	mature
immeasurable	measurable
immediate	mediate
immiscible	miscible
immobile	mobile
immoderate	moderate
immodest	modest
immoral	moral
immunocompetent	immunodeficient
immunodeficient	immunocompetent
immutable	mutable
impaired	unimpaired
impalpable	palpable
impartial	partial
impassable	passable
impatient	patient
impenetrable	penetrable
impenitent	penitent
imperceptible	perceptible
imperishable	perishable
impermanent	permanent
impermeable	permeable
impermissible	permissible
impersonal	personal
impervious	pervious
impious	pious
implacable	placable
implausible	plausible
implicit	explicit
impolite	polite
impolitic	politic
important	unimportant
impotent	potent
impractical	practical
imprecise	precise
impressionable	unimpressionable
impressive	unimpressive
improbable	probable
improper	proper
improved	unimproved
improvident	provident
imprudent	prudent
impure	pure
in_vitro	in_vivo
in_vivo	in_vitro
inaccessible	accessible
inaccurate	accurate
inactive	active
inadequate	adequate
inadmissible	admissible
inadvisable	advisable
inaesthetic	aesthetic
inalienable	alienable
inanimate	animate
inappropriate	appropriate
inarticulate	articulate
inattentive	attentive
inaudible	audible
inauspicious	auspicious
inboard	outboard
inbred	outbred
incalculable	calculable
incapable	capable
incautious	cautious
inclement	clement
inclined	vertical	disinclined	horizontal
inclusive	exclusive
incoherent	coherent
incommensurate	commensurate
incommodious	commodious
incommutable	commutable
incomparable	comparable
incompatible	compatible
incomplete	complete
incomprehensible	comprehensible
incompressible	compressible
inconclusive	conclusive
incongruent	congruent
incongruous	congruous
inconsiderable	considerable
inconsiderate	considerate
inconsistent	consistent
inconsolable	consolable
inconspicuous	conspicuous
inconstant	constant
incontestable	contestable
incontinent	continent
inconvenient	convenient
inconvertible	convertible
incorporeal	corporeal
incorrect	correct
incorrigible	corrigible
incorrupt	corrupt
increased	decreased
increasing	decreasing
incredible	credible
incredulous	credulous
inculpatory	exculpatory
incurious	curious
indecent	decent
indecisive	decisive
indecorous	decorous
indefeasible	defeasible
indefinite	definite
indehiscent	dehiscent
indestructible	destructible
indeterminable	determinable
indeterminate	determinate
indigestible	digestible
indirect	direct
indiscernible	discernible
indiscreet	discreet
indiscriminate	discriminate
indispensable	dispensable
indistinct	distinct
indistinguishable	distinguishable
indivisible	divisible
indoor	outdoor
induced	spontaneous
inductive	deductive
indulgent	nonindulgent
industrial	nonindustrial
inedible	edible
ineffective	effective
inefficacious	efficacious
inefficient	efficient
inelastic	elastic
inelegant	elegant
ineligible	eligible
inequitable	equitable
ineradicable	eradicable
inexact	exact
inexcusable	excusable
inexhaustible	exhaustible
inexpedient	expedient
inexperienced	experienced
inexplicable	explicable
inexpressible	expressible
inextinguishable	extinguishable
inextricable	extricable
infallible	fallible
infectious	noninfectious
infelicitous	felicitous
inflationary	deflationary
inflected	uninflected
inflectional	derivational
inflexible	flexible
influential	uninfluential
informal	formal
informative	uninformative
informed	uninformed
infrequent	frequent
ingenuous	disingenuous
inglorious	glorious
inhabited	uninhabited
inharmonious	harmonious
inheritable	noninheritable
inhibited	uninhibited
inhospitable	hospitable
inhumane	humane
injectable	uninjectable
injured	uninjured
inland	coastal
inner	outer
innocuous	noxious
innumerate	numerate
inoffensive	offensive
inoperable	operable
inoperative	operative
inopportune	opportune
inorganic	organic
inquisitorial	accusatorial
insane	sane
insatiate	satiate
insectivorous	omnivorous	carnivorous	herbivorous
insecure	secure
insensible	sensible
insensitive	sensitive
insentient	sentient
inshore	offshore
insignificant	significant
insincere	sincere
insoluble	soluble
inspiring	uninspiring
institutional	noninstitutional
institutionalized	noninstitutionalized
instructive	uninstructive
instrumental	vocal
insubordinate	subordinate
insubstantial	substantial
insufficient	sufficient
insurmountable	surmountable
integrated	nonintegrated	segregated
integrative	disintegrative
intelligent	unintelligent
intelligible	unintelligible
intemperate	temperate
intended	unintended
intense	mild
intensifying	moderating
intercontinental	continental
interdepartmental	intradepartmental
interested	uninterested
interesting	uninteresting
internal	external
interspecies	intraspecies
intestate	testate
intolerable	tolerable
intolerant	tolerant
intoxicated	sober
intra_vires	ultra_vires
intracellular	extracellular
intractable	tractable
intradepartmental	interdepartmental
intramural	extramural
intraspecies	interspecies
intrastate	interstate
intrinsic	extrinsic
introspective	extrospective
introversive	extroversive	ambiversive
intrusive	unintrusive	protrusive	extrusive
invasive	noninvasive	confined
invertible	non-invertible
invigorating	debilitating
inviolable	violable
invisible	visible
inviting	uninviting
involuntary	voluntary
involved	uninvolved
invulnerable	vulnerable
inward	outward
iodinating	de-iodinating
ionized	nonionized
ipsilateral	contralateral
ironed	unironed
irreconcilable	reconcilable
irreducible	reducible
irrelevant	relevant
irreligious	religious
irremediable	remediable
irremovable	removable
irreparable	reparable
irreplaceable	replaceable
irresistible	resistible
irresolute	resolute
irresponsible	responsible
irreverent	reverent
irreversible	reversible
irrevocable	revocable
isotonic	isometric	hypotonic	hypertonic
isotropic	anisotropic
jawed	jawless
jawless	jawed
joyful	sorrowful
joyless	joyous
joyous	joyless
judgmental	nonjudgmental
juiceless	juicy
juicy	juiceless
just	unjust
katabatic	anabatic
keyed	keyless
keyless	keyed
kindly	unkindly
knowable	unknowable
known	unknown
labeled	unlabeled
laced	unlaced
lamented	unlamented
landed	landless
landless	landed
late	middle	early
laureled	unlaureled
lawful	unlawful
lax	tense
leaded	unleaded
leafless	leafy
leafy	leafless
leaky	tight
leavened	unleavened
left-handed	right-handed	ambidextrous
legal	illegal
legato	staccato
legged	legless
legible	illegible
legless	legged
lengthwise	crosswise
lentic	lotic
leptorrhine	catarrhine	platyrrhine
leptosporangiate	eusporangiate
less	more
lesser	greater
lethargic	energetic
licit	illicit
lidded	lidless
lidless	lidded
light-duty	heavy-duty
light-footed	heavy-footed
lighted	unlighted
liked	disliked
likely	unlikely
limbed	limbless
limbless	limbed
lineal	collateral
linear	cubic	planar	nonlinear
lined	unlined
linguistic	nonlinguistic
lipless	lipped
lipped	lipless
listed	unlisted
livable	unlivable
lively	dull
liveried	unliveried
loaded	unloaded
loamless	loamy
loamy	loamless
logical	illogical
long-spurred	short-spurred
lossless	lossy
lossy	lossless
lotic	lentic
loud	soft
lovable	hateful
loved	unloved
loving	unloving
low-interest	high-interest
low-resolution	high-resolution
low-rise	high-rise
low-sudsing	high-sudsing
low-tech	high-tech
low-tension	high-tension
lowborn	noble
lower-class	middle-class	upper-class
lowered	raised
loyal	disloyal
lubricated	unlubricated
lucky	unlucky
machine-made	handmade
made	unmade
magnetic	geographic	antimagnetic	nonmagnetic
maladaptive	adaptive
maladjusted	adjusted
maladroit	adroit
malapropos	apropos
maleficent	beneficent
malfunctioning	functioning
malicious	unmalicious
malignant	benign
malnourished	nourished
malodorous	fragrant
manageable	unmanageable
manly	unmanly
manned	unmanned
many	few
marked	unmarked
masochistic	sadistic
matched	mismatched
mated	unmated
maternal	paternal
matriarchal	patriarchal
maximal	minimal
meager	ample
meagerly	amply
meaningful	meaningless
meaningless	meaningful
measurable	immeasurable
meatless	meaty
meaty	meatless
mechanical	nonmechanical
melodious	unmelodious
melted	unmelted
membered	memberless
memberless	membered
mental	physical
merciful	merciless
merciless	merciful
merited	unmerited
mesial	distal
mesic	hydric	xeric
mesomorphic	endomorphic	ectomorphic
metabolic	ametabolic
metamorphic	nonmetamorphic
middle-class	lower-class	upper-class
migratory	nonmigratory
mild	intense
mindful	unmindful
mined	unmined
minimal	maximal
miscible	immiscible
mismatched	matched
misused	used
mitigated	unmitigated
moderating	intensifying
modest	immodest
modifiable	unmodifiable
modified	unmodified
modulated	unmodulated
molecular	molar
monaural	binaural
moneyed	moneyless
moneyless	moneyed
monochromatic	polychromatic
monoclinic	triclinic
monoclinous	diclinous
monocotyledonous	dicotyledonous
monoecious	dioecious
monogamous	polygamous
mononuclear	binucleate	trinucleate
monophonic	polyphonic
monotheistic	polytheistic
monotonic	nonmonotonic
monovalent	polyvalent
moonless	moonlit
moonlit	moonless
most	least	fewest
motivated	unmotivated
motorized	unmotorized
moved	unmoved
moving	unmoving	still	nonmoving
mown	unmown
multidimensional	unidimensional
multiform	uniform
multilane	single-lane
multilateral	unilateral
multilingual	monolingual
multinucleate	uninucleate
multiparous	uniparous
multiple-choice	true-false
multivalent	bivalent	univalent
mutable	immutable
myelinated	unmyelinated
naive	sophisticated
narrow-minded	broad-minded
nascent	dying
nasty	nice
nearsighted	farsighted
necked	neckless
neckless	necked
negligent	diligent
new	old	worn
nidicolous	nidifugous
nidifugous	nidicolous
no-go	go
nocturnal	diurnal
noisy	quiet
nomothetic	idiographic
non-invertible	invertible
nonabsorbent	absorbent
nonaddictive	addictive
nonadhesive	adhesive
nonadsorbent	adsorbent
nonalcoholic	alcoholic
nonaligned	aligned
nonarbitrable	arbitrable
nonarbitrary	arbitrary
nonarboreal	arboreal
nonassociative	associative
nonastringent	astringent
nonbearing	bearing
noncausative	causative
noncellular	cellular
noncivilized	civilized
nonclassical	classical
noncollapsible	collapsible
noncolumned	columned
noncombinative	combinative
noncombustible	combustible
noncommercial	commercial
noncommissioned	commissioned
noncompetitive	competitive
noncomprehensive	comprehensive
nonconductive	conductive
noncritical	critical
noncrucial	crucial
noncrystalline	crystalline
noncurrent	current
noncyclic	cyclic
nondeductible	deductible
nondisposable	disposable
nonechoic	echoic
noneffervescent	effervescent
nonexempt	exempt
nonexistent	existent
nonexploratory	exploratory
nonexplosive	explosive
nonextensile	extensile
nonfat	fatty
nonfatal	fatal
nonfictional	fictional
nonfinancial	financial
nonfissile	fissile
nonfissionable	fissionable
nonfunctional	functional
nonharmonic	harmonic
nonhierarchical	hierarchical
nonhuman	human
nonimitative	imitative
nonindulgent	indulgent
nonindustrial	industrial
noninfectious	infectious
noninheritable	inheritable
noninstitutional	institutional
noninstitutionalized	institutionalized
nonintegrated	integrated
nonintellectual	intellectual
noninvasive	invasive
nonionic	ionic
nonionized	ionized
nonjudgmental	judgmental
nonlinear	linear
nonlinguistic	linguistic
nonmagnetic	magnetic
nonmechanical	mechanical
nonmetallic	metallic
nonmetamorphic	metamorphic
nonmigratory	migratory
nonmodern	modern
nonmonotonic	monotonic
nonmoving	moving
nonnative	native
nonoperational	operational
nonparticulate	particulate
nonpasserine	passerine
nonphotosynthetic	photosynthetic
nonpolitical	political
nonporous	porous
nonpregnant	pregnant
nonprehensile	prehensile
nonprescription	prescription
nonprofessional	professional
nonproprietary	proprietary
nonpsychoactive	psychoactive
nonracial	racial
nonradioactive	radioactive
nonrandom	random
nonreciprocal	reciprocal
nonreflective	reflective
nonrepetitive	repetitive
nonrepresentational	representational
nonrepresentative	representative
nonresidential	residential
nonreticulate	reticulate
nonretractile	retractile
nonreturnable	returnable
nonreversible	reversible
nonrigid	rigid
nonruminant	ruminant
nonsectarian	sectarian
nonsignificant	significant
nonslippery	slippery
nonspatial	spatial
nonspeaking	speaking
nonspecific	specific
nonspherical	spherical
nonstandard	standard
nonsubmersible	submersible
nonsuppurative	suppurative
nonsurgical	surgical
nonsyllabic	syllabic
nontaxable	taxable
nontechnical	technical
nonterritorial	territorial
nonthermal	thermal
nontoxic	toxic
nontraditional	traditional
nontranslational	translational
nonunion	union
nonviolent	violent
nonvolatile	volatile
nonwashable	washable
nonwoody	woody
normotensive	hypertensive	hypotensive
nosed	noseless
noseless	nosed
noticeable	unnoticeable
noticed	unnoticed
nourished	malnourished
noxious	innocuous
nuclear	conventional
numerical	verbal
obedient	disobedient
obligated	unobligated
obligatory	optional
obstructed	unobstructed
obtrusive	unobtrusive
obtuse	acute
obvious	unobvious
occupied	unoccupied
odd	even
odorless	odorous
odorous	odorless
off-line	on-line
off-site	on-site
off-street	on-street
offending	unoffending
offshore	inshore	onshore
oiled	unoiled
oleophilic	oleophobic
oleophobic	oleophilic
omnidirectional	directional
omnivorous	carnivorous	insectivorous	herbivorous
on	off
on-line	off-line
on-site	off-site
on-street	off-street
one-piece	three-piece	two-piece
onshore	offshore
onside	offside
onstage	offstage
onymous	anonymous
opaque	clear
operable	inoperable
operational	nonoperational
opisthognathous	prognathous
opportune	inopportune
opposable	unopposable
opposed	unopposed
optimistic	pessimistic
optional	obligatory
ordered	disordered
organized	unorganized	disorganized
oriented	unoriented
orienting	disorienting
orthodox	unorthodox
orthotropous	campylotropous
ostentatious	unostentatious
other	same
outbred	inbred
outdoor	indoor
outer	inner
outgoing	incoming
outward	inward
overhand	underhand
overt	covert
oviparous	viviparous	ovoviviparous
ovoviviparous	oviparous	viviparous
owned	unowned
packaged	unpackaged
paid	unpaid
painful	painless
painless	painful
paintable	unpaintable
painted	unpainted
palatable	unpalatable
palingenetic	cenogenetic
palpable	impalpable
paradigmatic	syntagmatic
paranormal	normal
pardonable	unpardonable
parental	filial
parented	unparented
part-time	full-time
passable	impassable
passionate	passionless
passionless	passionate
paternal	maternal
patriarchal	matriarchal
patriotic	unpatriotic
patronized	unpatronized
patterned	plain
paved	unpaved
peaceful	unpeaceful
pedunculate	sessile
penetrable	impenetrable
perceptible	imperceptible
perceptive	unperceptive
perinatal	prenatal	postnatal
periodic	aperiodic
peripteral	apteral
permeable	impermeable
permissible	impermissible
permissive	unpermissive	preventive
perplexed	unperplexed
persistent	caducous
persuasive	dissuasive
pervious	impervious
pessimistic	optimistic
petalous	apetalous
phlegmy	dry
photosynthetic	nonphotosynthetic
physical	mental
pigeon-toed	splayfooted
pious	impious
placable	implacable
planar	linear	cubic
planned	unplanned
planted	unplanted
plausible	implausible
playable	unplayable
playful	unplayful
pleasant	unpleasant
pleased	displeased
pleurocarpous	acrocarpous
plowed	unplowed
plucked	bowed
pointed	pointless
pointless	pointed
polar	equatorial
polished	unpolished
polite	impolite
politic	impolitic
political	nonpolitical
polychromatic	monochromatic
polygamous	monogamous
polyphonic	monophonic
polytheistic	monotheistic
polyvalent	monovalent
ponderable	imponderable
popular	unpopular
porous	nonporous
posed	unposed
postmeridian	antemeridian
postnatal	perinatal	prenatal
postnuptial	prenuptial
postprandial	preprandial
postwar	prewar
potent	impotent
potted	unpotted
powered	unpowered
powerful	powerless
powerless	powerful
practical	impractical
precedented	unprecedented
preceding	succeeding
precise	imprecise
precocial	altricial
precocious	retarded
predicative	attributive
predictable	unpredictable
pregnant	nonpregnant
prehensile	nonprehensile
prejudiced	unprejudiced
premature	full-term
premeditated	unpremeditated
prenatal	perinatal	postnatal
prenuptial	postnuptial
prepared	unprepared
preprandial	postprandial
prescriptive	descriptive
preserved	destroyed	fresh
presidential	unpresidential
pretentious	unpretentious
preventable	unpreventable
prewar	postwar
priestly	unpriestly
principled	unprincipled
printable	unprintable
privileged	underprivileged
pro-american	anti-American
pro-choice	pro-life
pro-life	pro-choice
proactive	retroactive
procaryotic	eucaryotic
processed	unprocessed
productive	unproductive
profitable	unprofitable
profound	superficial
prognathous	opisthognathous
prokaryotic	eukaryotic
prolate	oblate
prolix	concise
pronounceable	unpronounceable
proper	improper
prophetic	unprophetic
propitious	unpropitious
proportionate	disproportionate
prospective	retrospective
protected	unprotected
protective	unprotective
protrusive	intrusive
proud	humble
proved	unproved
provident	improvident
provocative	unprovocative
proximal	distal
proximate	ultimate
prudent	imprudent
psychoactive	nonpsychoactive
publicized	suppressed
publishable	unpublishable
published	unpublished
punctual	unpunctual
puncturable	punctureless
punctureless	puncturable
punished	unpunished
punitive	rehabilitative
pure	impure
purifying	adulterating
purposeful	purposeless
purposeless	purposeful
pyretic	antipyretic
quadrupedal	bipedal
qualified	unqualified
qualitative	quantitative
quantitative	syllabic	accentual	qualitative
questionable	unquestionable
quotable	unquotable
racial	nonracial
radioactive	nonradioactive
radiolucent	radiopaque
radiopaque	radiolucent
raised	lowered
random	nonrandom
re-entrant	salient
reactive	unreactive
realistic	unrealistic
reasonable	unreasonable
reassuring	unreassuring
receptive	unreceptive
reconcilable	irreconcilable
reconstructed	unreconstructed
recorded	live
recoverable	unrecoverable
reducible	irreducible
refined	unrefined
reflected	unreflected
reflective	nonreflective
registered	unregistered
regressive	progressive
regretful	unregretful
regulated	unregulated
rehabilitative	punitive
rejective	acceptive
related	unrelated
relaxed	tense
relevant	irrelevant
reliable	unreliable
remediable	irremediable
removable	irremovable
renewable	unrenewable
rentable	unrentable
reparable	irreparable
repeatable	unrepeatable
repentant	unrepentant
repetitive	nonrepetitive
replaceable	irreplaceable
reportable	unreportable
reported	unreported
representational	nonrepresentational
reproducible	unreproducible
repulsive	attractive
reputable	disreputable
requested	unrequested
resentful	unresentful
reserved	unreserved
residential	nonresidential
resistible	irresistible
resolute	irresolute
respectable	unrespectable
respectful	disrespectful
responsible	irresponsible
responsive	unresponsive
rested	tired
restful	restless
restless	restful
restrained	unrestrained
restricted	unrestricted
restrictive	unrestrictive
retentive	unretentive
retractile	nonretractile
retroactive	proactive
retrorse	antrorse
returnable	nonreturnable
reverberant	unreverberant
reverent	irreverent
revived	unrevived
revocable	irrevocable
rewarding	unrewarding
rh-negative	rh-positive
rh-positive	rh-negative
rhetorical	unrhetorical
rhymed	unrhymed
rhythmical	unrhythmical
ribbed	ribless
ribless	ribbed
rifled	unrifled
rigged	unrigged
right-handed	left-handed	ambidextrous
righteous	unrighteous
rigid	nonrigid
rimless	rimmed
rimmed	rimless
ripe	green
robust	frail
roofed	roofless
roofless	roofed
rounded	angular
rugged	delicate
run-on	end-stopped
rural	urban
rusted	rustless
rustless	rusted
sacred	profane
sad	glad
saddled	unsaddled
sadistic	masochistic
salable	unsalable
salaried	freelance
salty	fresh
sane	insane
sanitary	unsanitary
saponified	unsaponified
sarcastic	unsarcastic
satisfactory	unsatisfactory
saturated	unsaturated
saved	lost
scalable	unscalable
scarce	abundant
scented	scentless
scentless	scented
scheduled	unscheduled
scholarly	unscholarly
scientific	unscientific
scripted	unscripted
scrupulous	unscrupulous
sealed	unsealed
seamanlike	unseamanlike
seamed	seamless
seamless	seamed
seasonable	unseasonable
seasoned	unseasoned
seated	standing
seaworthy	unseaworthy
seductive	unseductive
seeded	unseeded
seedless	seedy
seedy	seedless
segregated	integrated
selected	unselected
selfish	unselfish
sensational	unsensational
sensible	insensible
sensory	extrasensory
sentient	insentient
septic	antiseptic
serious	frivolous
serviceable	unserviceable
servile	unservile
sessile	pedunculate	vagile
settled	unsettled
sexual	asexual
sexy	unsexy
shaded	unshaded
shapely	unshapely
shared	unshared
shaven	unshaven
sheared	unsheared
sheathed	unsheathed
shelled	unshelled
shockable	unshockable
shod	unshod
short-spurred	long-spurred
shrinkable	unshrinkable
shuttered	unshuttered
sidereal	civil
sighted	blind
signed	unsigned
significant	nonsignificant	insignificant
silenced	unsilenced
similar	dissimilar
sincere	insincere
single-barreled	double-barreled
single-breasted	double-breasted
single-lane	multilane
sinistral	dextral
sinkable	unsinkable
sisterly	brotherly
sized	unsized
skilled	unskilled
skinless	skinned
skinned	skinless
sleeved	sleeveless
sleeveless	sleeved
slippery	nonslippery
smokeless	smoky
smoky	smokeless
socialistic	capitalistic
soft	loud	hardened	hard
softhearted	hardhearted
sold	unsold
soled	soleless
soleless	soled
soluble	insoluble
solved	unsolved
some	no	all
sonic	subsonic	supersonic
sophisticated	naive
sorrowful	joyful
soured	unsoured
southern	northern
spaced	unspaced
spatial	nonspatial
specialized	unspecialized
specified	unspecified
spherical	nonspherical
spineless	spinous
spinous	spineless
spirited	spiritless
spiritless	spirited
splayfooted	pigeon-toed
spoken	written
spontaneous	induced
sporadic	continual
staccato	legato
staged	unstaged
stained	unstained
starchless	starchy
starchy	starchless
starless	starry
starry	starless
statesmanlike	unstatesmanlike
stative	active
stemless	stemmed
stemmed	stemless
sterile	fertile
steroidal	nonsteroidal
stimulating	unstimulating
stimulative	depressant
stingy	generous
stomatous	astomatous
stoppable	unstoppable
stormy	calm
strange	familiar
stratified	unstratified
stressed	unstressed
strong	weak
structured	unstructured
stubborn	docile
stuck	unstuck
studied	unstudied
styleless	stylish
stylish	styleless
subartesian	artesian
subhuman	superhuman
subjacent	superjacent
subjective	objective
submissive	domineering
subordinating	coordinating
subsequent	antecedent
subsonic	supersonic	sonic
substantial	insubstantial
subsurface	surface	overhead
subtractive	additive
succeeding	preceding
successful	unsuccessful
sudden	gradual
sufficient	insufficient
sugarless	sugary
sugary	sugarless
summery	vernal	autumnal	wintry
superficial	profound
superhuman	subhuman
superjacent	subjacent
supernal	infernal
supersonic	subsonic	sonic
supervised	unsupervised
supported	unsupported
supportive	unsupportive
suppressed	publicized
suppurative	nonsuppurative
sure	unsure
surface-to-air	air-to-surface	air-to-air
surgical	medical	nonsurgical
surmountable	insurmountable
surprised	unsurprised
surprising	unsurprising
susceptible	unsusceptible
suspected	unsuspected
swept	unswept
sworn	unsworn
syllabic	accentual	quantitative	nonsyllabic
symmetrical	asymmetrical
sympathetic	unsympathetic
sympatric	allopatric
syncarpous	apocarpous
syncategorematic	categorematic
synchronic	diachronic
synchronous	asynchronous
synclinal	anticlinal
syndetic	asyndetic
synergistic	antagonistic
synonymous	antonymous
syntagmatic	paradigmatic
systematic	unsystematic
taciturn	voluble
tactful	tactless
tactless	tactful
talented	untalented
tangible	intangible
tangled	untangled
tanned	untanned
tapped	untapped
tasteful	tasteless
tasteless	tasty	tasteful
tasty	tasteless
taxable	nontaxable
tearful	tearless
tearless	tearful
temperate	intemperate
tempered	untempered
terrestrial	aquatic	amphibious
thematic	unthematic
theoretical	applied	empirical
thermosetting	thermoplastic
thinkable	unthinkable
thirsty	hungry
thoughtful	thoughtless
thoughtless	thoughtful
three-piece	one-piece	two-piece
thrifty	wasteful
tied	untied
tight	loose	leaky
timbered	untimbered
tipped	untipped
tired	rested
toed	toeless
toeless	toed
tolerable	intolerable
tolerant	intolerant
tonal	atonal
toned	toneless
toneless	toned
tongued	tongueless
tongueless	tongued
toothed	toothless
toothless	toothed
top-down	bottom-up
topless	topped
topped	topless
touched	untouched
toxic	nontoxic
traceable	untraceable
tracked	trackless
trackless	tracked
tractable	intractable
traditional	nontraditional
trained	untrained
transeunt	immanent
translatable	untranslatable
translational	nontranslational
traveled	untraveled
treated	untreated
triclinic	monoclinic
trimmed	untrimmed
trinucleate	binucleate	mononuclear
troubled	untroubled
true-false	multiple-choice
trustful	distrustful
trustworthy	untrustworthy
truthful	untruthful
tubed	tubeless
tucked	untucked
tuneful	tuneless
tuneless	tuneful
turned	unturned
typical	atypical
ugly	beautiful
ultra_vires	intra_vires
unable	able
unabused	abused
unacceptable	acceptable
unaccommodating	accommodating
unaccompanied	accompanied
unaccustomed	accustomed
unacknowledged	acknowledged
unacquisitive	acquisitive
unactable	actable
unadaptable	adaptable
unaddicted	addicted
unaddressed	addressed
unadjusted	adjusted
unadoptable	adoptable
unadorned	adorned
unadventurous	adventurous
unaffected	affected
unaffixed	affixed
unafraid	afraid
unaggressive	aggressive
unagitated	agitated
unairworthy	airworthy
unalarming	alarming
unalert	alert
unalike	alike
unalterable	alterable
unaltered	altered
unambiguous	ambiguous
unambitious	ambitious
unamended	amended
unanalyzed	analyzed
unangry	angry
unanimated	animated
unapologetic	apologetic
unappealable	appealable
unappealing	appealing
unappendaged	appendaged
unappetizing	appetizing
unapproachable	approachable
unargumentative	argumentative
unarmed	armed
unarmored	armored
unarticulated	articulated
unashamed	ashamed
unassertive	assertive
unassigned	assigned
unassisted	assisted
unattached	attached
unattractive	attractive
unattributable	attributable
unauthorized	authorized
unavailable	available
unavenged	avenged
unawakened	awakened
unaware	aware
unawed	awed
unbalanced	balanced
unbalconied	balconied
unbanded	banded
unbaptized	baptized
unbarreled	barreled
unbelted	belted
unbeneficed	beneficed
unblemished	blemished
unblended	blended
unbodied	bodied
unbordered	bordered
unborn	born
unbound	bound
unbrainwashed	brainwashed
unbranded	branded
unbreakable	breakable
unbridgeable	bridgeable
unbroken	broken
unburdened	burdened
unburied	buried
unbuttoned	buttoned
uncamphorated	camphorated
uncared-for	cared-for
uncarpeted	carpeted
uncarved	carved
uncastrated	castrated
uncaulked	caulked
uncensored	censored
uncertain	certain
uncertified	certified
unchangeable	changeable
unchanged	changed
uncharacteristic	characteristic
uncharged	charged
uncharitable	charitable
unchartered	chartered
unchaste	chaste
unchristian	christian
uncivil	civil
unclassified	classified
unclean	clean
unclear	clear
uncleared	cleared
unclothed	clothed
uncoated	coated
uncoiled	coiled
uncollected	collected
uncolored	colored
uncombed	combed
uncombined	combined
uncomfortable	comfortable
uncommitted	committed
uncommon	common
uncommunicative	communicative
uncompartmented	compartmented
uncompassionate	compassionate
uncomplaining	complaining
uncomplimentary	complimentary
uncompromising	compromising
unconcealed	concealed
unconcerned	concerned
unconditional	conditional
unconditioned	conditioned
unconfined	confined
unconfirmed	confirmed
uncongenial	congenial
unconnected	connected
unconquerable	conquerable
unconscientious	conscientious
unconstipated	constipated
unconstitutional	constitutional
unconstricted	constricted
unconsummated	consummated
uncontaminated	contaminated
uncontested	contested
uncontrolled	controlled
uncontroversial	controversial
unconventional	conventional
unconvinced	convinced
unconvincing	convincing
uncooperative	cooperative
uncorrected	corrected
uncousinly	cousinly
uncrannied	crannied
uncreative	creative
uncritical	critical
uncrossed	crossed
uncrowded	crowded
uncrowned	crowned
uncrystallized	crystallized
uncultivated	cultivated
uncut	cut
undamaged	damaged
undatable	datable
undeciphered	deciphered
undeclared	declared
undedicated	dedicated
undefeated	defeated
undefined	defined
undelineated	delineated
undemanding	demanding
undemocratic	democratic
undemonstrative	demonstrative
undeniable	deniable
undependable	dependable
underhand	overhand
underived	derived
underprivileged	privileged
understood	ununderstood
undescriptive	descriptive
undesigned	designed
undesirous	desirous
undetected	detected
undetermined	determined
undeveloped	developed
undifferentiated	differentiated
undignified	dignified
undiluted	diluted
undimmed	dimmed
undiplomatic	diplomatic
undiscerning	discerning
undiscriminating	discriminating
undiversified	diversified
undocumented	documented
undomestic	domestic
undrained	drained
undramatic	dramatic
undrinkable	drinkable
undue	due
undynamic	dynamic
uneager	eager
unearned	earned
uneasy	easy
unedifying	edifying
uneducated	educated
unemotional	emotional
unemployable	employable
unenclosed	enclosed
unencumbered	encumbered
unendowed	endowed
unenforceable	enforceable
unenforced	enforced
unenlightened	enlightened
unenlightening	enlightening
unenlivened	enlivened
unenterprising	enterprising
unenthusiastic	enthusiastic
unequal	equal
unequipped	equipped
unequivocal	equivocal
unerect	erect
unestablished	established
unethical	ethical
uneven	even
uneventful	eventful
unexchangeable	exchangeable
unexcitable	excitable
unexcited	excited
unexciting	exciting
unexhausted	exhausted
unexpansive	expansive
unexpected	expected
unexpendable	expendable
unexpired	expired
unexploited	exploited
unexportable	exportable
unextended	extended
unfaceted	faceted
unfair	fair
unfaithful	faithful
unfamiliar	familiar
unfashionable	fashionable
unfastened	fastened
unfastidious	fastidious
unfathomable	fathomable
unfavorable	favorable
unfeathered	feathered
unfilled	filled
unfinished	finished
unfixed	fixed
unflattering	flattering
unfledged	fledged
unfocused	focused
unforgettable	forgettable
unforgiving	forgiving
unformed	formed
unframed	framed
unfree	free
unfretted	fretted
unfriendly	friendly
unfrozen	frozen
unfruitful	fruitful
unfueled	fueled
unfunded	funded
unfurnished	furnished
unfurrowed	furrowed
ungathered	gathered
ungeared	geared
ungenerous	generous
unglazed	glazed
ungracious	gracious
ungrammatical	grammatical
ungrateful	grateful
ungregarious	gregarious
ungroomed	groomed
unguided	guided
ungusseted	gusseted
unhappy	happy
unheaded	headed
unhealthful	healthful
unhealthy	healthy
unhelpful	helpful
unholy	holy
unhurried	hurried
unicameral	bicameral
unidentifiable	identifiable
unidimensional	multidimensional
unidirectional	bidirectional
unilateral	multilateral
unimodal	bimodal
unimpaired	impaired
unimportant	important
unimpressionable	impressionable
unimpressive	impressive
unimproved	improved
uninflected	inflected
uninfluential	influential
uninformative	informative
uninformed	informed
uninhabited	inhabited
uninhibited	inhibited
uninjectable	injectable
uninjured	injured
uninquiring	inquiring
uninspiring	inspiring
uninstructive	instructive
uninsured	insured
unintelligent	intelligent
unintelligible	intelligible
unintended	intended
uninterested	interested
uninteresting	interesting
unintrusive	intrusive
uninucleate	multinucleate
uninviting	inviting
uninvolved	involved
uniparous	multiparous
unipolar	bipolar
unironed	ironed
unitary	federal
united	divided
univalent	multivalent	bivalent
unjust	just
unkind	kind
unkindly	kindly
unknowable	knowable
unlabeled	labeled
unlaced	laced
unlamented	lamented
unlaureled	laureled
unlawful	lawful
unleaded	leaded
unleavened	leavened
unlighted	lighted
unlike	like
unlikely	likely
unlimited	limited
unlined	lined
unlisted	listed
unlivable	livable
unliveried	liveried
unloaded	loaded
unloved	loved
unloving	loving
unlubricated	lubricated
unlucky	lucky
unmade	made
unmalicious	malicious
unmalted	malted
unmanageable	manageable
unmanly	manly
unmanned	manned
unmarked	marked
unmarried	married
unmated	mated
unmelodious	melodious
unmelted	melted
unmerited	merited
unmilitary	military
unmindful	mindful
unmined	mined
unmitigated	mitigated
unmodifiable	modifiable
unmodified	modified
unmodulated	modulated
unmotivated	motivated
unmotorized	motorized
unmoved	moved
unmoving	moving
unmown	mown
unmusical	musical
unmyelinated	myelinated
unnatural	natural
unnecessary	necessary
unneurotic	neurotic
unnoticeable	noticeable
unnoticed	noticed
unobligated	obligated
unobstructed	obstructed
unobtrusive	obtrusive
unobvious	obvious
unoccupied	occupied
unoffending	offending
unofficial	official
unoiled	oiled
unopposable	opposable
unopposed	opposed
unorganized	organized
unoriented	oriented
unoriginal	original
unorthodox	orthodox
unostentatious	ostentatious
unowned	owned
unpackaged	packaged
unpaid	paid
unpaintable	paintable
unpainted	painted
unpalatable	palatable
unpardonable	pardonable
unparented	parented
unpatriotic	patriotic
unpatronized	patronized
unpaved	paved
unpeaceful	peaceful
unperceptive	perceptive
unpermissive	permissive
unperplexed	perplexed
unplanned	planned
unplanted	planted
unplayable	playable
unplayful	playful
unpleasant	pleasant
unplowed	plowed
unpolished	polished
unpopular	popular
unportable	portable
unposed	posed
unpotted	potted
unpowered	powered
unprecedented	precedented
unpredictable	predictable
unprejudiced	prejudiced
unpremeditated	premeditated
unprepared	prepared
unpresidential	presidential
unpretentious	pretentious
unpreventable	preventable
unpriestly	priestly
unprincipled	principled
unprintable	printable
unprocessed	processed
unproductive	productive
unprofessional	professional
unprofitable	profitable
unpronounceable	pronounceable
unprophetic	prophetic
unpropitious	propitious
unprotected	protected
unprotective	protective
unproved	proved
unprovocative	provocative
unpublishable	publishable
unpublished	published
unpunctual	punctual
unpunished	punished
unqualified	qualified
unquestionable	questionable
unquiet	quiet
unquotable	quotable
unreactive	reactive
unready	ready
unreal	real
unrealistic	realistic
unreasonable	reasonable
unreassuring	reassuring
unreceptive	receptive
unreconstructed	reconstructed
unrecoverable	recoverable
unrefined	refined
unreflected	reflected
unregenerate	regenerate
unregistered	registered
unregretful	regretful
unregulated	regulated
unrelated	related
unreliable	reliable
unrenewable	renewable
unrentable	rentable
unrepeatable	repeatable
unrepentant	repentant
unreportable	reportable
unreported	reported
unreproducible	reproducible
unrequested	requested
unresentful	resentful
unreserved	reserved
unrespectable	respectable
unresponsive	responsive
unrestrained	restrained
unrestricted	restricted
unrestrictive	restrictive
unretentive	retentive
unreverberant	reverberant
unrevived	revived
unrewarding	rewarding
unrhetorical	rhetorical
unrhymed	rhymed
unrhythmical	rhythmical
unrifled	rifled
unrigged	rigged
unrighteous	righteous
unsaddled	saddled
unsalable	salable
unsanitary	sanitary
unsaponified	saponified
unsarcastic	sarcastic
unsatisfactory	satisfactory
unsaturated	saturated
unsavory	savory
unscalable	scalable
unscheduled	scheduled
unscholarly	scholarly
unscientific	scientific
unscripted	scripted
unscrupulous	scrupulous
unsealed	sealed
unseamanlike	seamanlike
unseasonable	seasonable
unseasoned	seasoned
unseaworthy	seaworthy
unseductive	seductive
unseeded	seeded
unselected	selected
unselfish	selfish
unsensational	sensational
unsent	sent
unserviceable	serviceable
unservile	servile
unsettled	settled
unsexy	sexy
unshaded	shaded
unshapely	shapely
unshared	shared
unshaven	shaven
unsheared	sheared
unsheathed	sheathed
unshelled	shelled
unshockable	shockable
unshod	shod
unshrinkable	shrinkable
unshuttered	shuttered
unsigned	signed
unsilenced	silenced
unsinkable	sinkable
unsized	sized
unskilled	skilled
unsociable	sociable
unsocial	social
unsold	sold
unsolved	solved
unsound	sound
unsoured	soured
unspaced	spaced
unspecialized	specialized
unspecified	specified
unstable	stable
unstaged	staged
unstained	stained
unstatesmanlike	statesmanlike
unsteady	steady
unstimulating	stimulating
unstoppable	stoppable
unstratified	stratified
unstressed	stressed
unstructured	structured
unstuck	stuck
unstudied	studied
unsuccessful	successful
unsupervised	supervised
unsupported	supported
unsupportive	supportive
unsure	sure
unsurprised	surprised
unsurprising	surprising
unsusceptible	susceptible
unsuspected	suspected
unswept	swept
unsworn	sworn
unsympathetic	sympathetic
unsystematic	systematic
untalented	talented
untangled	tangled
untanned	tanned
untapped	tapped
untempered	tempered
untheatrical	theatrical
unthematic	thematic
unthinkable	thinkable
untidy	tidy
untied	tied
untimbered	timbered
untipped	tipped
untouched	touched
untraceable	traceable
untrained	trained
untranslatable	translatable
untraveled	traveled
untreated	treated
untrimmed	trimmed
untroubled	troubled
untrustworthy	trustworthy
untruthful	truthful
untucked	tucked
unturned	turned
ununderstood	understood
unusual	usual
unvaried	varied
unveiled	veiled
unventilated	ventilated
unvoiced	voiced
unwanted	wanted
unwary	wary
unwaxed	waxed
unweaned	weaned
unwearable	wearable
unwebbed	webbed
unwelcome	welcome
unwholesome	wholesome
unwieldy	wieldy
unwilling	willing
unwitting	witting
unwomanly	womanly
unwooded	wooded
unworldly	worldly
unworthy	worthy
unwoven	woven
unwrapped	wrapped
unwrinkled	wrinkled
unwritten	written
upmarket	downmarket
upper-class	middle-class	lower-class
upstream	downstream
upward	downward
upwind	downwind
urban	rural
used	misused
useful	useless
useless	useful
usual	unusual
vagile	sessile
valid	invalid
varied	unvaried
vascular	avascular
veiled	unveiled
ventilated	unventilated
ventral	dorsal
verbal	numerical
vernal	autumnal	wintry	summery
violable	inviolable
violent	nonviolent
virtuous	wicked
virulent	avirulent
visible	invisible
viviparous	oviparous	ovoviviparous
vocalic	consonantal
voiced	unvoiced
voluble	taciturn
vulnerable	invulnerable
walleyed	cross-eyed
wanted	unwanted
warm-blooded	cold-blooded
warmhearted	coldhearted
wary	unwary
washable	nonwashable
wasteful	thrifty
waxed	unwaxed
weak	strong
weakly	strongly
weaned	unweaned
webbed	unwebbed
weedless	weedy
weedy	weedless
weightless	weighty
weighty	weightless
well-advised	ill-advised
well-defined	ill-defined
wheeled	wheelless
wheelless	wheeled
white-collar	blue-collar
wholesome	unwholesome
wicked	virtuous
wide	narrow
wieldy	unwieldy
wifely	husbandly
wigged	wigless
wigless	wigged
winged	wingless
wingless	winged
wintry	vernal	autumnal	summery
wired	wireless
witting	unwitting
womanly	unwomanly
wooded	unwooded
woody	nonwoody
worldly	unworldly
worn	new
worthless	valuable
woven	unwoven
wrapped	unwrapped
wrinkled	unwrinkled
written	unwritten	spoken
xenogeneic	allogeneic
xeric	mesic	hydric
year-round	seasonal
zonal	azonal
zygodactyl	heterodactyl
zygomorphic	actinomorphic
abaxially	adaxially
aborad	orad
abstractly	concretely
acceptably	unacceptably
accidentally	deliberately
accurately	inaccurately
actively	passively
acutely	chronically
adaxially	abaxially
adequately	inadequately
adroitly	maladroitly
advantageously	disadvantageously
advertently	inadvertently
agreeably	disagreeably
amateurishly	expertly
ambiguously	unambiguously
ambitiously	unambitiously
amply	meagerly
appealingly	unappealingly
appreciatively	unappreciatively
appropriately	inappropriately
approvingly	disapprovingly
articulately	inarticulately
artificially	naturally
ashamedly	unashamedly
assertively	unassertively
asymmetrically	symmetrically
at_best	at_worst
at_least	at_most
at_most	at_least
at_the_least	at_the_most
at_the_most	at_the_least
at_worst	at_best
attractively	unattractively
atypically	typically
audibly	inaudibly
auspiciously	inauspiciously
badly	well
believably	unbelievably
believingly	unbelievingly
below	above
benevolently	malevolently
binaurally	monaurally
bloodily	bloodlessly
bloodlessly	bloodily
broad-mindedly	narrow-mindedly
broadly	narrowly
by_all_means	by_no_means
by_hand	by_machine
by_machine	by_hand
by_no_means	by_all_means
carefully	carelessly
carelessly	carefully
cautiously	incautiously
centrally	peripherally
ceremoniously	unceremoniously
characteristically	uncharacteristically
cheaply	expensively
cheerfully	cheerlessly
cheerlessly	cheerfully
chivalrously	unchivalrously
chronically	acutely
civilly	uncivilly
coarsely	finely
coherently	incoherently
comfortably	uncomfortably
comparably	incomparably
compatibly	incompatibly
competently	incompetently
competitively	noncompetitively
complainingly	uncomplainingly
comprehensively	noncomprehensively
concavely	convexly
conclusively	inconclusively
concretely	abstractly
conditionally	unconditionally
consciously	unconsciously
consequentially	inconsequentially
considerately	inconsiderately
consistently	inconsistently
conspicuously	inconspicuously
constitutionally	unconstitutionally
controversially	uncontroversially
conveniently	inconveniently
conventionally	unconventionally
convexly	concavely
convincingly	unconvincingly
correctly	incorrectly
courteously	discourteously
covertly	overtly
credibly	incredibly
credulously	incredulously
critically	uncritically
decently	indecently
decisively	indecisively
decorously	indecorously
defensively	offensively
deliberately	accidentally
democratically	undemocratically
dependably	undependably
deservedly	undeservedly
diplomatically	undiplomatically
directly	indirectly
disadvantageously	advantageously
disagreeably	agreeably
disapprovingly	approvingly
discouragingly	encouragingly
discourteously	courteously
discreetly	indiscreetly
dishonestly	honestly
dishonorably	honorably
disloyally	loyally
disobediently	obediently
disproportionately	proportionately
disreputably	reputably
disrespectfully	respectfully
distrustfully	trustfully
downriver	upriver
downwardly	upwardly
downwards	upwards
dramatically	undramatically
effectively	ineffectively
effectually	ineffectually
efficaciously	inefficaciously
efficiently	inefficiently
elegantly	inelegantly
eloquently	ineloquently
emotionally	unemotionally
empirically	theoretically
encouragingly	discouragingly
enthusiastically	unenthusiastically
equally	unequally
equitably	inequitably
ethically	unethically
evenly	unevenly
ever	never
exactly	inexactly
excitingly	unexcitingly
excusably	inexcusably
expediently	inexpediently
expensively	cheaply
expertly	amateurishly
explicitly	implicitly
expressively	inexpressively
externally	internally
fairly	unfairly
faithfully	unfaithfully
fashionably	unfashionably
favorably	unfavorably
fearfully	fearlessly
fearlessly	fearfully
feelingly	unfeelingly
felicitously	infelicitously
figuratively	literally
finely	coarsely
finitely	infinitely
flexibly	inflexibly
foolishly	wisely
forgivably	unforgivably
forgivingly	unforgivingly
formally	informally
fortunately	unfortunately
frequently	infrequently
fruitfully	fruitlessly
fruitlessly	fruitfully
generally	specifically
geometrically	linearly
gracefully	gracelessly	ungracefully
gracelessly	gracefully
graciously	ungraciously
grammatically	ungrammatically
gratefully	ungratefully
grudgingly	ungrudgingly
happily	sadly	unhappily
harmfully	harmlessly
harmlessly	harmfully
heavily	lightly
helpfully	unhelpfully
hesitantly	unhesitatingly
honestly	dishonestly
honorably	dishonorably
hopefully	hopelessly
hopelessly	hopefully
hospitably	inhospitably
humanely	inhumanely
humorlessly	humorously
humorously	humorlessly
hurriedly	unhurriedly
hygienically	unhygienically
illegibly	legibly
illegitimately	legitimately
illicitly	licitly
illogically	logically
imaginatively	unimaginatively
immaturely	maturely
immeasurably	measurably
immoderately	moderately
immodestly	modestly
immorally	morally
impatiently	patiently
impenitently	penitently
imperceptibly	perceptibly
imperfectly	perfectly
impermissibly	permissibly
impersonally	personally
implicitly	explicitly
impolitely	politely
impossibly	possibly
imprecisely	precisely
impressively	unimpressively
improperly	properly
improvidently	providently
imprudently	prudently
in_hand	out_of_hand
inaccurately	accurately
inadequately	adequately
inadvertently	advertently
inappropriately	appropriately
inarticulately	articulately
inaudibly	audibly
inauspiciously	auspiciously
incautiously	cautiously
incoherently	coherently
incomparably	comparably
incompatibly	compatibly
incompetently	competently
inconclusively	conclusively
inconsequentially	consequentially
inconsiderately	considerately
inconsistently	consistently
inconspicuously	conspicuously
inconveniently	conveniently
incorrectly	correctly
incredibly	credibly
incredulously	credulously
indecently	decently
indecisively	decisively
indecorously	decorously
indirectly	directly
indiscreetly	discreetly
indoors	outdoors
ineffectively	effectively
ineffectually	effectually
inefficaciously	efficaciously
inefficiently	efficiently
inelegantly	elegantly
ineloquently	eloquently
inequitably	equitably
inexactly	exactly
inexcusably	excusably
inexpediently	expediently
inexpressively	expressively
infelicitously	felicitously
infinitely	finitely
inflexibly	flexibly
informally	formally
informatively	uninformatively
infrequently	frequently
inhospitably	hospitably
inhumanely	humanely
injudiciously	judiciously
inoffensively	offensively
inopportunely	opportunely
inorganically	organically
insanely	sanely
insecurely	securely
insensitively	sensitively
inseparably	separably
insignificantly	significantly
insincerely	sincerely
instructively	uninstructively
insufficiently	sufficiently
intelligently	unintelligently
intelligibly	unintelligibly
intentionally	unintentionally
interestingly	uninterestingly
internally	externally
intolerably	tolerably
intolerantly	tolerantly
intransitively	transitively
invisibly	visibly
involuntarily	voluntarily
inwardly	outwardly
irrationally	rationally
irregularly	regularly
irrelevantly	relevantly
irresolutely	resolutely
irresponsibly	responsibly
irreverently	reverently
joyfully	joylessly
joylessly	joyfully
judiciously	injudiciously
justifiably	unjustifiably
justly	unjustly
knowingly	unknowingly
lawfully	lawlessly	unlawfully
lawlessly	lawfully
legibly	illegibly
legitimately	illegitimately
licitly	illicitly
lightly	heavily
linearly	geometrically
literally	figuratively
logically	illogically
loudly	softly
loyally	disloyally
luckily	unluckily
maladroitly	adroitly
malevolently	benevolently
manageably	unmanageably
manfully	unmanfully
maturely	immaturely
maximally	minimally
measurably	immeasurably
melodiously	unmelodiously
memorably	unmemorably
mindfully	unmindfully
minimally	maximally
moderately	immoderately
modestly	immodestly
monaurally	binaurally
morally	immorally
multilaterally	unilaterally
musically	unmusically
narrow-mindedly	broad-mindedly
narrowly	broadly
naturally	unnaturally	artificially
necessarily	unnecessarily
never	ever
no_longer	still
noisily	quietly
noncompetitively	competitively
noncomprehensively	comprehensively
nonviolently	violently
obediently	disobediently
objectively	subjectively
obligatorily	optionally
obtrusively	unobtrusively
offensively	defensively	inoffensively
officially	unofficially
often	rarely
on_the_one_hand	on_the_other_hand
on_the_other_hand	on_the_one_hand
opportunely	inopportunely
optimistically	pessimistically
optionally	obligatorily
orad	aborad
organically	inorganically
out_of_hand	in_hand
outwardly	inwardly
overtly	covertly
painfully	painlessly
painlessly	painfully
palatably	unpalatably
pardonably	unpardonably
partly	wholly
passively	actively
patiently	impatiently
patriotically	unpatriotically
penitently	impenitently
perceptibly	imperceptibly
perfectly	imperfectly
peripherally	centrally
permanently	temporarily
permissibly	impermissibly
personally	impersonally
pessimistically	optimistically
pleasantly	unpleasantly
politely	impolitely
possibly	impossibly
precedentedly	unprecedentedly
precisely	imprecisely
pretentiously	unpretentiously
primarily	secondarily
privately	publicly
productively	unproductively
profitably	unprofitably
properly	improperly
propitiously	unpropitiously
proportionately	disproportionately
providently	improvidently
prudently	imprudently
publicly	privately
quickly	slowly
quietly	noisily	unquietly
rarely	often
rationally	irrationally
realistically	unrealistically
reasonably	unreasonably
recognizably	unrecognizably
regularly	irregularly
relevantly	irrelevantly
reliably	unreliably
remarkably	unremarkably
repentantly	unrepentantly
reputably	disreputably
resolutely	irresolutely
respectfully	disrespectfully
responsibly	irresponsibly
reverently	irreverently
righteously	unrighteously
romantically	unromantically
sadly	happily
sanely	insanely
satisfactorily	unsatisfactorily
seasonably	unseasonably
secondarily	primarily
securely	insecurely
self-consciously	unselfconsciously
selfishly	unselfishly
sensitively	insensitively
sentimentally	unsentimentally
separably	inseparably
significantly	insignificantly
sincerely	insincerely
singly	multiply
slowly	quickly
smilingly	unsmilingly
sociably	unsociably
softly	loudly
specifically	generally
sportingly	unsportingly
steadily	unsteadily
strongly	weakly
subjectively	objectively
successfully	unsuccessfully
sufficiently	insufficiently
suitably	unsuitably
symmetrically	asymmetrically
sympathetically	unsympathetically
systematically	unsystematically
tactfully	tactlessly
tactlessly	tactfully
tastefully	tastelessly
tastelessly	tastefully
temporarily	permanently
theoretically	empirically
thickly	thinly
thinly	thickly
thoughtfully	thoughtlessly
thoughtlessly	thoughtfully
tolerably	intolerably
tolerantly	intolerantly
transitively	intransitively
trustfully	distrustfully
truthfully	untruthfully
typically	atypically
unacceptably	acceptably
unambiguously	ambiguously
unambitiously	ambitiously
unappealingly	appealingly
unappreciatively	appreciatively
unashamedly	ashamedly
unassertively	assertively
unattractively	attractively
unbelievably	believably
unbelievingly	believingly
unceremoniously	ceremoniously
uncharacteristically	characteristically
unchivalrously	chivalrously
uncivilly	civilly
uncomfortably	comfortably
uncomplainingly	complainingly
unconditionally	conditionally
unconsciously	consciously
unconstitutionally	constitutionally
uncontroversially	controversially
unconventionally	conventionally
unconvincingly	convincingly
uncritically	critically
undemocratically	democratically
undependably	dependably
undeservedly	deservedly
undiplomatically	diplomatically
undramatically	dramatically
unemotionally	emotionally
unenthusiastically	enthusiastically
unequally	equally
unethically	ethically
unevenly	evenly
unexcitingly	excitingly
unfairly	fairly
unfaithfully	faithfully
unfashionably	fashionably
unfavorably	favorably
unfeelingly	feelingly
unforgivably	forgivably
unforgivingly	forgivingly
unfortunately	fortunately
ungracefully	gracefully
ungraciously	graciously
ungrammatically	grammatically
ungratefully	gratefully
ungrudgingly	grudgingly
unhappily	happily
unhelpfully	helpfully
unhesitatingly	hesitantly
unhurriedly	hurriedly
unhygienically	hygienically
unilaterally	multilaterally
unimaginatively	imaginatively
unimpressively	impressively
uninformatively	informatively
uninstructively	instructively
unintelligently	intelligently
unintelligibly	intelligibly
unintentionally	intentionally
uninterestingly	interestingly
unjustifiably	justifiably
unjustly	justly
unknowingly	knowingly
unlawfully	lawfully
unluckily	luckily
unmanageably	manageably
unmanfully	manfully
unmelodiously	melodiously
unmemorably	memorably
unmindfully	mindfully
unmusically	musically
unnaturally	naturally
unnecessarily	necessarily
unobtrusively	obtrusively
unofficially	officially
unpalatably	palatably
unpardonably	pardonably
unpatriotically	patriotically
unpleasantly	pleasantly
unprecedentedly	precedentedly
unpretentiously	pretentiously
unproductively	productively
unprofitably	profitably
unpropitiously	propitiously
unquietly	quietly
unrealistically	realistically
unreasonably	reasonably
unrecognizably	recognizably
unreliably	reliably
unremarkably	remarkably
unrepentantly	repentantly
unrighteously	righteously
unromantically	romantically
unsatisfactorily	satisfactorily
unseasonably	seasonably
unselfconsciously	self-consciously
unselfishly	selfishly
unsentimentally	sentimentally
unsmilingly	smilingly
unsociably	sociably
unsportingly	sportingly
unsteadily	steadily
unsuccessfully	successfully
unsuitably	suitably
unsympathetically	sympathetically
unsystematically	systematically
untruthfully	truthfully
unwarily	warily
unwillingly	willingly
unwittingly	wittingly
upriver	downriver
upwardly	downwardly
upwards	downwards
usefully	uselessly
uselessly	usefully
violently	nonviolently
visibly	invisibly
voluntarily	involuntarily
warily	unwarily
wholly	partly
willingly	unwillingly
wisely	foolishly
wittingly	unwittingly
wrongly	right